Year,District Code,District Name,Neighborhood Code,Neighborhood Name,Age,Immigrants,Emigrants,Diferencia
2017,1,Ciutat Vella,1,el Raval,0-4,154,108,46
2017,1,Ciutat Vella,2,el Barri Gòtic,0-4,58,33,25
2017,1,Ciutat Vella,3,la Barceloneta,0-4,38,37,1
2017,1,Ciutat Vella,4,"Sant Pere, Santa Caterina i la Ribera",0-4,56,55,1
2017,2,Eixample,5,el Fort Pienc,0-4,79,60,19
2017,2,Eixample,6,la Sagrada Família,0-4,111,95,16
2017,2,Eixample,7,la Dreta de l'Eixample,0-4,121,78,43
2017,2,Eixample,8,l'Antiga Esquerra de l'Eixample,0-4,97,63,34
2017,2,Eixample,9,la Nova Esquerra de l'Eixample,0-4,123,130,-7
2017,2,Eixample,10,Sant Antoni,0-4,57,80,-23
2017,3,Sants-Montjuïc,11,el Poble Sec,0-4,80,99,-19
2017,3,Sants-Montjuïc,12,la Marina del Prat Vermell,0-4,1,2,-1
2017,3,Sants-Montjuïc,13,la Marina de Port,0-4,71,59,12
2017,3,Sants-Montjuïc,14,la Font de la Guatlla,0-4,14,15,-1
2017,3,Sants-Montjuïc,15,Hostafrancs,0-4,31,37,-6
2017,3,Sants-Montjuïc,16,la Bordeta,0-4,33,39,-6
2017,3,Sants-Montjuïc,17,Sants - Badal,0-4,49,57,-8
2017,3,Sants-Montjuïc,18,Sants,0-4,106,83,23
2017,4,Les Corts,19,les Corts,0-4,103,73,30
2017,4,Les Corts,20,la Maternitat i Sant Ramon,0-4,81,55,26
2017,4,Les Corts,21,Pedralbes,0-4,36,16,20
2017,5,Sarrià-Sant Gervasi,22,"Vallvidrera, el Tibidabo i les Planes",0-4,20,16,4
2017,5,Sarrià-Sant Gervasi,23,Sarrià,0-4,87,61,26
2017,5,Sarrià-Sant Gervasi,24,les Tres Torres,0-4,72,28,44
2017,5,Sarrià-Sant Gervasi,25,Sant Gervasi - la Bonanova,0-4,59,30,29
2017,5,Sarrià-Sant Gervasi,26,Sant Gervasi - Galvany,0-4,141,82,59
2017,5,Sarrià-Sant Gervasi,27,el Putxet i el Farró,0-4,74,64,10
2017,6,Gràcia,28,Vallcarca i els Penitents,0-4,37,39,-2
2017,6,Gràcia,29,el Coll,0-4,18,16,2
2017,6,Gràcia,30,la Salut,0-4,41,23,18
2017,6,Gràcia,31,la Vila de Gràcia,0-4,88,104,-16
2017,6,Gràcia,32,el Camp d'en Grassot i Gràcia Nova,0-4,73,68,5
2017,7,Horta-Guinardó,33,el Baix Guinardó,0-4,48,44,4
2017,7,Horta-Guinardó,34,Can Baró,0-4,16,17,-1
2017,7,Horta-Guinardó,35,el Guinardó,0-4,72,71,1
2017,7,Horta-Guinardó,36,la Font d'en Fargues,0-4,14,9,5
2017,7,Horta-Guinardó,37,el Carmel,0-4,66,65,1
2017,7,Horta-Guinardó,38,la Teixonera,0-4,15,18,-3
2017,7,Horta-Guinardó,39,Sant Genís dels Agudells,0-4,15,18,-3
2017,7,Horta-Guinardó,40,Montbau,0-4,11,6,5
2017,7,Horta-Guinardó,41,la Vall d'Hebron,0-4,11,7,4
2017,7,Horta-Guinardó,42,la Clota,0-4,1,0,1
2017,7,Horta-Guinardó,43,Horta,0-4,50,38,12
2017,8,Nou Barris,44,Vilapicina i la Torre Llobeta,0-4,51,36,15
2017,8,Nou Barris,45,Porta,0-4,66,49,17
2017,8,Nou Barris,46,el Turó de la Peira,0-4,64,35,29
2017,8,Nou Barris,47,Can Peguera,0-4,3,1,2
2017,8,Nou Barris,48,la Guineueta,0-4,23,33,-10
2017,8,Nou Barris,49,Canyelles,0-4,6,7,-1
2017,8,Nou Barris,50,les Roquetes,0-4,57,26,31
2017,8,Nou Barris,51,Verdun,0-4,33,19,14
2017,8,Nou Barris,52,la Prosperitat,0-4,56,44,12
2017,8,Nou Barris,53,la Trinitat Nova,0-4,22,25,-3
2017,8,Nou Barris,54,Torre Baró,0-4,5,4,1
2017,8,Nou Barris,55,Ciutat Meridiana,0-4,47,25,22
2017,8,Nou Barris,56,Vallbona,0-4,5,9,-4
2017,9,Sant Andreu,57,la Trinitat Vella,0-4,40,29,11
2017,9,Sant Andreu,58,Baró de Viver,0-4,5,5,0
2017,9,Sant Andreu,59,el Bon Pastor,0-4,31,29,2
2017,9,Sant Andreu,60,Sant Andreu,0-4,90,70,20
2017,9,Sant Andreu,61,la Sagrera,0-4,45,43,2
2017,9,Sant Andreu,62,el Congrés i els Indians,0-4,17,19,-2
2017,9,Sant Andreu,63,Navas,0-4,26,32,-6
2017,10,Sant Martí,64,el Camp de l'Arpa del Clot,0-4,88,75,13
2017,10,Sant Martí,65,el Clot,0-4,43,25,18
2017,10,Sant Martí,66,el Parc i la Llacuna del Poblenou,0-4,30,26,4
2017,10,Sant Martí,67,la Vila Olímpica del Poblenou,0-4,29,18,11
2017,10,Sant Martí,68,el Poblenou,0-4,94,75,19
2017,10,Sant Martí,69,Diagonal Mar i el Front Marítim del Poblenou,0-4,68,61,7
2017,10,Sant Martí,70,el Besòs i el Maresme,0-4,125,67,58
2017,10,Sant Martí,71,Provençals del Poblenou,0-4,53,38,15
2017,10,Sant Martí,72,Sant Martí de Provençals,0-4,48,38,10
2017,10,Sant Martí,73,la Verneda i la Pau,0-4,70,50,20
2017,1,Ciutat Vella,1,el Raval,5-9,133,85,48
2017,1,Ciutat Vella,2,el Barri Gòtic,5-9,46,20,26
2017,1,Ciutat Vella,3,la Barceloneta,5-9,26,23,3
2017,1,Ciutat Vella,4,"Sant Pere, Santa Caterina i la Ribera",5-9,39,26,13
2017,2,Eixample,5,el Fort Pienc,5-9,59,42,17
2017,2,Eixample,6,la Sagrada Família,5-9,81,44,37
2017,2,Eixample,7,la Dreta de l'Eixample,5-9,75,60,15
2017,2,Eixample,8,l'Antiga Esquerra de l'Eixample,5-9,63,34,29
2017,2,Eixample,9,la Nova Esquerra de l'Eixample,5-9,91,53,38
2017,2,Eixample,10,Sant Antoni,5-9,43,37,6
2017,3,Sants-Montjuïc,11,el Poble Sec,5-9,60,57,3
2017,3,Sants-Montjuïc,12,la Marina del Prat Vermell,5-9,2,1,1
2017,3,Sants-Montjuïc,13,la Marina de Port,5-9,54,41,13
2017,3,Sants-Montjuïc,14,la Font de la Guatlla,5-9,13,9,4
2017,3,Sants-Montjuïc,15,Hostafrancs,5-9,22,14,8
2017,3,Sants-Montjuïc,16,la Bordeta,5-9,27,21,6
2017,3,Sants-Montjuïc,17,Sants - Badal,5-9,42,40,2
2017,3,Sants-Montjuïc,18,Sants,5-9,79,45,34
2017,4,Les Corts,19,les Corts,5-9,71,31,40
2017,4,Les Corts,20,la Maternitat i Sant Ramon,5-9,44,43,1
2017,4,Les Corts,21,Pedralbes,5-9,40,25,15
2017,5,Sarrià-Sant Gervasi,22,"Vallvidrera, el Tibidabo i les Planes",5-9,12,8,4
2017,5,Sarrià-Sant Gervasi,23,Sarrià,5-9,61,23,38
2017,5,Sarrià-Sant Gervasi,24,les Tres Torres,5-9,49,27,22
2017,5,Sarrià-Sant Gervasi,25,Sant Gervasi - la Bonanova,5-9,41,19,22
2017,5,Sarrià-Sant Gervasi,26,Sant Gervasi - Galvany,5-9,80,59,21
2017,5,Sarrià-Sant Gervasi,27,el Putxet i el Farró,5-9,54,38,16
2017,6,Gràcia,28,Vallcarca i els Penitents,5-9,28,13,15
2017,6,Gràcia,29,el Coll,5-9,9,4,5
2017,6,Gràcia,30,la Salut,5-9,24,10,14
2017,6,Gràcia,31,la Vila de Gràcia,5-9,58,53,5
2017,6,Gràcia,32,el Camp d'en Grassot i Gràcia Nova,5-9,34,36,-2
2017,7,Horta-Guinardó,33,el Baix Guinardó,5-9,30,25,5
2017,7,Horta-Guinardó,34,Can Baró,5-9,13,8,5
2017,7,Horta-Guinardó,35,el Guinardó,5-9,39,40,-1
2017,7,Horta-Guinardó,36,la Font d'en Fargues,5-9,4,5,-1
2017,7,Horta-Guinardó,37,el Carmel,5-9,50,36,14
2017,7,Horta-Guinardó,38,la Teixonera,5-9,16,11,5
2017,7,Horta-Guinardó,39,Sant Genís dels Agudells,5-9,15,4,11
2017,7,Horta-Guinardó,40,Montbau,5-9,6,5,1
2017,7,Horta-Guinardó,41,la Vall d'Hebron,5-9,7,4,3
2017,7,Horta-Guinardó,42,la Clota,5-9,3,1,2
2017,7,Horta-Guinardó,43,Horta,5-9,33,22,11
2017,8,Nou Barris,44,Vilapicina i la Torre Llobeta,5-9,35,26,9
2017,8,Nou Barris,45,Porta,5-9,57,22,35
2017,8,Nou Barris,46,el Turó de la Peira,5-9,36,14,22
2017,8,Nou Barris,47,Can Peguera,5-9,2,1,1
2017,8,Nou Barris,48,la Guineueta,5-9,20,11,9
2017,8,Nou Barris,49,Canyelles,5-9,3,2,1
2017,8,Nou Barris,50,les Roquetes,5-9,32,17,15
2017,8,Nou Barris,51,Verdun,5-9,36,25,11
2017,8,Nou Barris,52,la Prosperitat,5-9,35,35,0
2017,8,Nou Barris,53,la Trinitat Nova,5-9,21,18,3
2017,8,Nou Barris,54,Torre Baró,5-9,10,12,-2
2017,8,Nou Barris,55,Ciutat Meridiana,5-9,42,24,18
2017,8,Nou Barris,56,Vallbona,5-9,7,3,4
2017,9,Sant Andreu,57,la Trinitat Vella,5-9,38,20,18
2017,9,Sant Andreu,58,Baró de Viver,5-9,5,5,0
2017,9,Sant Andreu,59,el Bon Pastor,5-9,28,22,6
2017,9,Sant Andreu,60,Sant Andreu,5-9,56,55,1
2017,9,Sant Andreu,61,la Sagrera,5-9,48,25,23
2017,9,Sant Andreu,62,el Congrés i els Indians,5-9,15,13,2
2017,9,Sant Andreu,63,Navas,5-9,24,19,5
2017,10,Sant Martí,64,el Camp de l'Arpa del Clot,5-9,38,39,-1
2017,10,Sant Martí,65,el Clot,5-9,19,18,1
2017,10,Sant Martí,66,el Parc i la Llacuna del Poblenou,5-9,12,7,5
2017,10,Sant Martí,67,la Vila Olímpica del Poblenou,5-9,21,9,12
2017,10,Sant Martí,68,el Poblenou,5-9,44,49,-5
2017,10,Sant Martí,69,Diagonal Mar i el Front Marítim del Poblenou,5-9,36,30,6
2017,10,Sant Martí,70,el Besòs i el Maresme,5-9,87,54,33
2017,10,Sant Martí,71,Provençals del Poblenou,5-9,23,22,1
2017,10,Sant Martí,72,Sant Martí de Provençals,5-9,31,18,13
2017,10,Sant Martí,73,la Verneda i la Pau,5-9,47,28,19
2017,1,Ciutat Vella,1,el Raval,10-14,117,56,61
2017,1,Ciutat Vella,2,el Barri Gòtic,10-14,26,10,16
2017,1,Ciutat Vella,3,la Barceloneta,10-14,11,14,-3
2017,1,Ciutat Vella,4,"Sant Pere, Santa Caterina i la Ribera",10-14,36,24,12
2017,2,Eixample,5,el Fort Pienc,10-14,42,23,19
2017,2,Eixample,6,la Sagrada Família,10-14,77,34,43
2017,2,Eixample,7,la Dreta de l'Eixample,10-14,61,43,18
2017,2,Eixample,8,l'Antiga Esquerra de l'Eixample,10-14,54,36,18
2017,2,Eixample,9,la Nova Esquerra de l'Eixample,10-14,51,40,11
2017,2,Eixample,10,Sant Antoni,10-14,57,37,20
2017,3,Sants-Montjuïc,11,el Poble Sec,10-14,64,54,10
2017,3,Sants-Montjuïc,12,la Marina del Prat Vermell,10-14,0,6,-6
2017,3,Sants-Montjuïc,13,la Marina de Port,10-14,66,38,28
2017,3,Sants-Montjuïc,14,la Font de la Guatlla,10-14,8,11,-3
2017,3,Sants-Montjuïc,15,Hostafrancs,10-14,23,15,8
2017,3,Sants-Montjuïc,16,la Bordeta,10-14,28,27,1
2017,3,Sants-Montjuïc,17,Sants - Badal,10-14,42,19,23
2017,3,Sants-Montjuïc,18,Sants,10-14,69,40,29
2017,4,Les Corts,19,les Corts,10-14,58,26,32
2017,4,Les Corts,20,la Maternitat i Sant Ramon,10-14,42,33,9
2017,4,Les Corts,21,Pedralbes,10-14,66,16,50
2017,5,Sarrià-Sant Gervasi,22,"Vallvidrera, el Tibidabo i les Planes",10-14,7,5,2
2017,5,Sarrià-Sant Gervasi,23,Sarrià,10-14,57,33,24
2017,5,Sarrià-Sant Gervasi,24,les Tres Torres,10-14,34,17,17
2017,5,Sarrià-Sant Gervasi,25,Sant Gervasi - la Bonanova,10-14,81,15,66
2017,5,Sarrià-Sant Gervasi,26,Sant Gervasi - Galvany,10-14,105,54,51
2017,5,Sarrià-Sant Gervasi,27,el Putxet i el Farró,10-14,64,22,42
2017,6,Gràcia,28,Vallcarca i els Penitents,10-14,20,11,9
2017,6,Gràcia,29,el Coll,10-14,21,5,16
2017,6,Gràcia,30,la Salut,10-14,19,8,11
2017,6,Gràcia,31,la Vila de Gràcia,10-14,49,29,20
2017,6,Gràcia,32,el Camp d'en Grassot i Gràcia Nova,10-14,35,29,6
2017,7,Horta-Guinardó,33,el Baix Guinardó,10-14,36,24,12
2017,7,Horta-Guinardó,34,Can Baró,10-14,5,6,-1
2017,7,Horta-Guinardó,35,el Guinardó,10-14,54,33,21
2017,7,Horta-Guinardó,36,la Font d'en Fargues,10-14,9,7,2
2017,7,Horta-Guinardó,37,el Carmel,10-14,42,17,25
2017,7,Horta-Guinardó,38,la Teixonera,10-14,15,21,-6
2017,7,Horta-Guinardó,39,Sant Genís dels Agudells,10-14,25,10,15
2017,7,Horta-Guinardó,40,Montbau,10-14,6,7,-1
2017,7,Horta-Guinardó,41,la Vall d'Hebron,10-14,7,4,3
2017,7,Horta-Guinardó,42,la Clota,10-14,0,0,0
2017,7,Horta-Guinardó,43,Horta,10-14,49,18,31
2017,8,Nou Barris,44,Vilapicina i la Torre Llobeta,10-14,36,15,21
2017,8,Nou Barris,45,Porta,10-14,54,29,25
2017,8,Nou Barris,46,el Turó de la Peira,10-14,41,17,24
2017,8,Nou Barris,47,Can Peguera,10-14,1,1,0
2017,8,Nou Barris,48,la Guineueta,10-14,20,17,3
2017,8,Nou Barris,49,Canyelles,10-14,5,2,3
2017,8,Nou Barris,50,les Roquetes,10-14,42,20,22
2017,8,Nou Barris,51,Verdun,10-14,21,26,-5
2017,8,Nou Barris,52,la Prosperitat,10-14,39,14,25
2017,8,Nou Barris,53,la Trinitat Nova,10-14,21,18,3
2017,8,Nou Barris,54,Torre Baró,10-14,6,8,-2
2017,8,Nou Barris,55,Ciutat Meridiana,10-14,31,13,18
2017,8,Nou Barris,56,Vallbona,10-14,3,1,2
2017,9,Sant Andreu,57,la Trinitat Vella,10-14,28,14,14
2017,9,Sant Andreu,58,Baró de Viver,10-14,4,3,1
2017,9,Sant Andreu,59,el Bon Pastor,10-14,26,16,10
2017,9,Sant Andreu,60,Sant Andreu,10-14,55,22,33
2017,9,Sant Andreu,61,la Sagrera,10-14,47,28,19
2017,9,Sant Andreu,62,el Congrés i els Indians,10-14,16,12,4
2017,9,Sant Andreu,63,Navas,10-14,36,19,17
2017,10,Sant Martí,64,el Camp de l'Arpa del Clot,10-14,46,29,17
2017,10,Sant Martí,65,el Clot,10-14,32,15,17
2017,10,Sant Martí,66,el Parc i la Llacuna del Poblenou,10-14,19,17,2
2017,10,Sant Martí,67,la Vila Olímpica del Poblenou,10-14,8,13,-5
2017,10,Sant Martí,68,el Poblenou,10-14,44,32,12
2017,10,Sant Martí,69,Diagonal Mar i el Front Marítim del Poblenou,10-14,27,9,18
2017,10,Sant Martí,70,el Besòs i el Maresme,10-14,86,34,52
2017,10,Sant Martí,71,Provençals del Poblenou,10-14,26,16,10
2017,10,Sant Martí,72,Sant Martí de Provençals,10-14,28,16,12
2017,10,Sant Martí,73,la Verneda i la Pau,10-14,44,27,17
2017,1,Ciutat Vella,1,el Raval,15-19,257,64,193
2017,1,Ciutat Vella,2,el Barri Gòtic,15-19,90,25,65
2017,1,Ciutat Vella,3,la Barceloneta,15-19,44,10,34
2017,1,Ciutat Vella,4,"Sant Pere, Santa Caterina i la Ribera",15-19,210,47,163
2017,2,Eixample,5,el Fort Pienc,15-19,87,20,67
2017,2,Eixample,6,la Sagrada Família,15-19,148,45,103
2017,2,Eixample,7,la Dreta de l'Eixample,15-19,107,33,74
2017,2,Eixample,8,l'Antiga Esquerra de l'Eixample,15-19,109,27,82
2017,2,Eixample,9,la Nova Esquerra de l'Eixample,15-19,153,55,98
2017,2,Eixample,10,Sant Antoni,15-19,91,40,51
2017,3,Sants-Montjuïc,11,el Poble Sec,15-19,173,62,111
2017,3,Sants-Montjuïc,12,la Marina del Prat Vermell,15-19,1,3,-2
2017,3,Sants-Montjuïc,13,la Marina de Port,15-19,123,66,57
2017,3,Sants-Montjuïc,14,la Font de la Guatlla,15-19,29,8,21
2017,3,Sants-Montjuïc,15,Hostafrancs,15-19,54,16,38
2017,3,Sants-Montjuïc,16,la Bordeta,15-19,41,25,16
2017,3,Sants-Montjuïc,17,Sants - Badal,15-19,67,34,33
2017,3,Sants-Montjuïc,18,Sants,15-19,120,51,69
2017,4,Les Corts,19,les Corts,15-19,116,49,67
2017,4,Les Corts,20,la Maternitat i Sant Ramon,15-19,44,31,13
2017,4,Les Corts,21,Pedralbes,15-19,66,20,46
2017,5,Sarrià-Sant Gervasi,22,"Vallvidrera, el Tibidabo i les Planes",15-19,5,3,2
2017,5,Sarrià-Sant Gervasi,23,Sarrià,15-19,76,32,44
2017,5,Sarrià-Sant Gervasi,24,les Tres Torres,15-19,36,16,20
2017,5,Sarrià-Sant Gervasi,25,Sant Gervasi - la Bonanova,15-19,95,28,67
2017,5,Sarrià-Sant Gervasi,26,Sant Gervasi - Galvany,15-19,119,48,71
2017,5,Sarrià-Sant Gervasi,27,el Putxet i el Farró,15-19,61,24,37
2017,6,Gràcia,28,Vallcarca i els Penitents,15-19,30,12,18
2017,6,Gràcia,29,el Coll,15-19,19,7,12
2017,6,Gràcia,30,la Salut,15-19,77,14,63
2017,6,Gràcia,31,la Vila de Gràcia,15-19,109,28,81
2017,6,Gràcia,32,el Camp d'en Grassot i Gràcia Nova,15-19,47,23,24
2017,7,Horta-Guinardó,33,el Baix Guinardó,15-19,41,6,35
2017,7,Horta-Guinardó,34,Can Baró,15-19,19,9,10
2017,7,Horta-Guinardó,35,el Guinardó,15-19,75,31,44
2017,7,Horta-Guinardó,36,la Font d'en Fargues,15-19,13,2,11
2017,7,Horta-Guinardó,37,el Carmel,15-19,76,44,32
2017,7,Horta-Guinardó,38,la Teixonera,15-19,24,10,14
2017,7,Horta-Guinardó,39,Sant Genís dels Agudells,15-19,47,13,34
2017,7,Horta-Guinardó,40,Montbau,15-19,7,3,4
2017,7,Horta-Guinardó,41,la Vall d'Hebron,15-19,9,6,3
2017,7,Horta-Guinardó,42,la Clota,15-19,4,1,3
2017,7,Horta-Guinardó,43,Horta,15-19,70,18,52
2017,8,Nou Barris,44,Vilapicina i la Torre Llobeta,15-19,55,31,24
2017,8,Nou Barris,45,Porta,15-19,74,33,41
2017,8,Nou Barris,46,el Turó de la Peira,15-19,60,17,43
2017,8,Nou Barris,47,Can Peguera,15-19,6,9,-3
2017,8,Nou Barris,48,la Guineueta,15-19,20,13,7
2017,8,Nou Barris,49,Canyelles,15-19,9,2,7
2017,8,Nou Barris,50,les Roquetes,15-19,55,27,28
2017,8,Nou Barris,51,Verdun,15-19,47,15,32
2017,8,Nou Barris,52,la Prosperitat,15-19,79,35,44
2017,8,Nou Barris,53,la Trinitat Nova,15-19,28,14,14
2017,8,Nou Barris,54,Torre Baró,15-19,4,3,1
2017,8,Nou Barris,55,Ciutat Meridiana,15-19,55,14,41
2017,8,Nou Barris,56,Vallbona,15-19,3,4,-1
2017,9,Sant Andreu,57,la Trinitat Vella,15-19,48,16,32
2017,9,Sant Andreu,58,Baró de Viver,15-19,5,2,3
2017,9,Sant Andreu,59,el Bon Pastor,15-19,45,12,33
2017,9,Sant Andreu,60,Sant Andreu,15-19,74,53,21
2017,9,Sant Andreu,61,la Sagrera,15-19,55,22,33
2017,9,Sant Andreu,62,el Congrés i els Indians,15-19,35,6,29
2017,9,Sant Andreu,63,Navas,15-19,47,16,31
2017,10,Sant Martí,64,el Camp de l'Arpa del Clot,15-19,64,29,35
2017,10,Sant Martí,65,el Clot,15-19,51,29,22
2017,10,Sant Martí,66,el Parc i la Llacuna del Poblenou,15-19,83,11,72
2017,10,Sant Martí,67,la Vila Olímpica del Poblenou,15-19,15,14,1
2017,10,Sant Martí,68,el Poblenou,15-19,54,30,24
2017,10,Sant Martí,69,Diagonal Mar i el Front Marítim del Poblenou,15-19,31,16,15
2017,10,Sant Martí,70,el Besòs i el Maresme,15-19,111,35,76
2017,10,Sant Martí,71,Provençals del Poblenou,15-19,31,25,6
2017,10,Sant Martí,72,Sant Martí de Provençals,15-19,48,34,14
2017,10,Sant Martí,73,la Verneda i la Pau,15-19,64,34,30
2017,1,Ciutat Vella,1,el Raval,20-24,864,157,707
2017,1,Ciutat Vella,2,el Barri Gòtic,20-24,493,45,448
2017,1,Ciutat Vella,3,la Barceloneta,20-24,342,38,304
2017,1,Ciutat Vella,4,"Sant Pere, Santa Caterina i la Ribera",20-24,458,91,367
2017,2,Eixample,5,el Fort Pienc,20-24,324,62,262
2017,2,Eixample,6,la Sagrada Família,20-24,537,97,440
2017,2,Eixample,7,la Dreta de l'Eixample,20-24,458,61,397
2017,2,Eixample,8,l'Antiga Esquerra de l'Eixample,20-24,521,75,446
2017,2,Eixample,9,la Nova Esquerra de l'Eixample,20-24,552,94,458
2017,2,Eixample,10,Sant Antoni,20-24,359,85,274
2017,3,Sants-Montjuïc,11,el Poble Sec,20-24,429,127,302
2017,3,Sants-Montjuïc,12,la Marina del Prat Vermell,20-24,6,6,0
2017,3,Sants-Montjuïc,13,la Marina de Port,20-24,177,88,89
2017,3,Sants-Montjuïc,14,la Font de la Guatlla,20-24,82,30,52
2017,3,Sants-Montjuïc,15,Hostafrancs,20-24,169,50,119
2017,3,Sants-Montjuïc,16,la Bordeta,20-24,112,50,62
2017,3,Sants-Montjuïc,17,Sants - Badal,20-24,201,75,126
2017,3,Sants-Montjuïc,18,Sants,20-24,420,145,275
2017,4,Les Corts,19,les Corts,20-24,273,86,187
2017,4,Les Corts,20,la Maternitat i Sant Ramon,20-24,182,46,136
2017,4,Les Corts,21,Pedralbes,20-24,57,15,42
2017,5,Sarrià-Sant Gervasi,22,"Vallvidrera, el Tibidabo i les Planes",20-24,12,8,4
2017,5,Sarrià-Sant Gervasi,23,Sarrià,20-24,96,46,50
2017,5,Sarrià-Sant Gervasi,24,les Tres Torres,20-24,65,21,44
2017,5,Sarrià-Sant Gervasi,25,Sant Gervasi - la Bonanova,20-24,126,41,85
2017,5,Sarrià-Sant Gervasi,26,Sant Gervasi - Galvany,20-24,229,63,166
2017,5,Sarrià-Sant Gervasi,27,el Putxet i el Farró,20-24,173,38,135
2017,6,Gràcia,28,Vallcarca i els Penitents,20-24,110,23,87
2017,6,Gràcia,29,el Coll,20-24,53,14,39
2017,6,Gràcia,30,la Salut,20-24,87,25,62
2017,6,Gràcia,31,la Vila de Gràcia,20-24,473,82,391
2017,6,Gràcia,32,el Camp d'en Grassot i Gràcia Nova,20-24,239,43,196
2017,7,Horta-Guinardó,33,el Baix Guinardó,20-24,151,36,115
2017,7,Horta-Guinardó,34,Can Baró,20-24,53,15,38
2017,7,Horta-Guinardó,35,el Guinardó,20-24,234,81,153
2017,7,Horta-Guinardó,36,la Font d'en Fargues,20-24,33,11,22
2017,7,Horta-Guinardó,37,el Carmel,20-24,200,69,131
2017,7,Horta-Guinardó,38,la Teixonera,20-24,73,24,49
2017,7,Horta-Guinardó,39,Sant Genís dels Agudells,20-24,42,24,18
2017,7,Horta-Guinardó,40,Montbau,20-24,27,10,17
2017,7,Horta-Guinardó,41,la Vall d'Hebron,20-24,14,8,6
2017,7,Horta-Guinardó,42,la Clota,20-24,6,1,5
2017,7,Horta-Guinardó,43,Horta,20-24,123,56,67
2017,8,Nou Barris,44,Vilapicina i la Torre Llobeta,20-24,122,55,67
2017,8,Nou Barris,45,Porta,20-24,161,61,100
2017,8,Nou Barris,46,el Turó de la Peira,20-24,109,42,67
2017,8,Nou Barris,47,Can Peguera,20-24,4,6,-2
2017,8,Nou Barris,48,la Guineueta,20-24,53,24,29
2017,8,Nou Barris,49,Canyelles,20-24,14,3,11
2017,8,Nou Barris,50,les Roquetes,20-24,152,45,107
2017,8,Nou Barris,51,Verdun,20-24,88,32,56
2017,8,Nou Barris,52,la Prosperitat,20-24,164,72,92
2017,8,Nou Barris,53,la Trinitat Nova,20-24,64,24,40
2017,8,Nou Barris,54,Torre Baró,20-24,10,7,3
2017,8,Nou Barris,55,Ciutat Meridiana,20-24,113,45,68
2017,8,Nou Barris,56,Vallbona,20-24,4,6,-2
2017,9,Sant Andreu,57,la Trinitat Vella,20-24,80,47,33
2017,9,Sant Andreu,58,Baró de Viver,20-24,18,10,8
2017,9,Sant Andreu,59,el Bon Pastor,20-24,83,27,56
2017,9,Sant Andreu,60,Sant Andreu,20-24,198,87,111
2017,9,Sant Andreu,61,la Sagrera,20-24,161,52,109
2017,9,Sant Andreu,62,el Congrés i els Indians,20-24,81,24,57
2017,9,Sant Andreu,63,Navas,20-24,109,31,78
2017,10,Sant Martí,64,el Camp de l'Arpa del Clot,20-24,298,78,220
2017,10,Sant Martí,65,el Clot,20-24,175,57,118
2017,10,Sant Martí,66,el Parc i la Llacuna del Poblenou,20-24,171,17,154
2017,10,Sant Martí,67,la Vila Olímpica del Poblenou,20-24,28,13,15
2017,10,Sant Martí,68,el Poblenou,20-24,165,42,123
2017,10,Sant Martí,69,Diagonal Mar i el Front Marítim del Poblenou,20-24,47,9,38
2017,10,Sant Martí,70,el Besòs i el Maresme,20-24,271,102,169
2017,10,Sant Martí,71,Provençals del Poblenou,20-24,93,26,67
2017,10,Sant Martí,72,Sant Martí de Provençals,20-24,110,65,45
2017,10,Sant Martí,73,la Verneda i la Pau,20-24,130,51,79
2017,1,Ciutat Vella,1,el Raval,25-29,1393,327,1066
2017,1,Ciutat Vella,2,el Barri Gòtic,25-29,763,131,632
2017,1,Ciutat Vella,3,la Barceloneta,25-29,482,104,378
2017,1,Ciutat Vella,4,"Sant Pere, Santa Caterina i la Ribera",25-29,795,162,633
2017,2,Eixample,5,el Fort Pienc,25-29,556,144,412
2017,2,Eixample,6,la Sagrada Família,25-29,912,244,668
2017,2,Eixample,7,la Dreta de l'Eixample,25-29,788,182,606
2017,2,Eixample,8,l'Antiga Esquerra de l'Eixample,25-29,927,206,721
2017,2,Eixample,9,la Nova Esquerra de l'Eixample,25-29,1092,268,824
2017,2,Eixample,10,Sant Antoni,25-29,655,169,486
2017,3,Sants-Montjuïc,11,el Poble Sec,25-29,780,205,575
2017,3,Sants-Montjuïc,12,la Marina del Prat Vermell,25-29,0,2,-2
2017,3,Sants-Montjuïc,13,la Marina de Port,25-29,228,121,107
2017,3,Sants-Montjuïc,14,la Font de la Guatlla,25-29,177,53,124
2017,3,Sants-Montjuïc,15,Hostafrancs,25-29,321,89,232
2017,3,Sants-Montjuïc,16,la Bordeta,25-29,200,87,113
2017,3,Sants-Montjuïc,17,Sants - Badal,25-29,303,145,158
2017,3,Sants-Montjuïc,18,Sants,25-29,611,196,415
2017,4,Les Corts,19,les Corts,25-29,483,177,306
2017,4,Les Corts,20,la Maternitat i Sant Ramon,25-29,282,116,166
2017,4,Les Corts,21,Pedralbes,25-29,95,36,59
2017,5,Sarrià-Sant Gervasi,22,"Vallvidrera, el Tibidabo i les Planes",25-29,19,8,11
2017,5,Sarrià-Sant Gervasi,23,Sarrià,25-29,153,65,88
2017,5,Sarrià-Sant Gervasi,24,les Tres Torres,25-29,69,37,32
2017,5,Sarrià-Sant Gervasi,25,Sant Gervasi - la Bonanova,25-29,153,77,76
2017,5,Sarrià-Sant Gervasi,26,Sant Gervasi - Galvany,25-29,414,156,258
2017,5,Sarrià-Sant Gervasi,27,el Putxet i el Farró,25-29,328,95,233
2017,6,Gràcia,28,Vallcarca i els Penitents,25-29,136,52,84
2017,6,Gràcia,29,el Coll,25-29,82,28,54
2017,6,Gràcia,30,la Salut,25-29,142,47,95
2017,6,Gràcia,31,la Vila de Gràcia,25-29,994,209,785
2017,6,Gràcia,32,el Camp d'en Grassot i Gràcia Nova,25-29,472,129,343
2017,7,Horta-Guinardó,33,el Baix Guinardó,25-29,287,122,165
2017,7,Horta-Guinardó,34,Can Baró,25-29,99,29,70
2017,7,Horta-Guinardó,35,el Guinardó,25-29,359,123,236
2017,7,Horta-Guinardó,36,la Font d'en Fargues,25-29,52,28,24
2017,7,Horta-Guinardó,37,el Carmel,25-29,272,128,144
2017,7,Horta-Guinardó,38,la Teixonera,25-29,106,53,53
2017,7,Horta-Guinardó,39,Sant Genís dels Agudells,25-29,67,20,47
2017,7,Horta-Guinardó,40,Montbau,25-29,65,28,37
2017,7,Horta-Guinardó,41,la Vall d'Hebron,25-29,28,6,22
2017,7,Horta-Guinardó,42,la Clota,25-29,4,1,3
2017,7,Horta-Guinardó,43,Horta,25-29,189,80,109
2017,8,Nou Barris,44,Vilapicina i la Torre Llobeta,25-29,186,81,105
2017,8,Nou Barris,45,Porta,25-29,235,73,162
2017,8,Nou Barris,46,el Turó de la Peira,25-29,131,62,69
2017,8,Nou Barris,47,Can Peguera,25-29,10,4,6
2017,8,Nou Barris,48,la Guineueta,25-29,73,43,30
2017,8,Nou Barris,49,Canyelles,25-29,11,11,0
2017,8,Nou Barris,50,les Roquetes,25-29,126,61,65
2017,8,Nou Barris,51,Verdun,25-29,133,53,80
2017,8,Nou Barris,52,la Prosperitat,25-29,208,81,127
2017,8,Nou Barris,53,la Trinitat Nova,25-29,76,40,36
2017,8,Nou Barris,54,Torre Baró,25-29,11,9,2
2017,8,Nou Barris,55,Ciutat Meridiana,25-29,136,44,92
2017,8,Nou Barris,56,Vallbona,25-29,8,12,-4
2017,9,Sant Andreu,57,la Trinitat Vella,25-29,106,54,52
2017,9,Sant Andreu,58,Baró de Viver,25-29,9,8,1
2017,9,Sant Andreu,59,el Bon Pastor,25-29,113,56,57
2017,9,Sant Andreu,60,Sant Andreu,25-29,332,175,157
2017,9,Sant Andreu,61,la Sagrera,25-29,268,104,164
2017,9,Sant Andreu,62,el Congrés i els Indians,25-29,101,42,59
2017,9,Sant Andreu,63,Navas,25-29,202,82,120
2017,10,Sant Martí,64,el Camp de l'Arpa del Clot,25-29,549,179,370
2017,10,Sant Martí,65,el Clot,25-29,298,87,211
2017,10,Sant Martí,66,el Parc i la Llacuna del Poblenou,25-29,213,59,154
2017,10,Sant Martí,67,la Vila Olímpica del Poblenou,25-29,65,18,47
2017,10,Sant Martí,68,el Poblenou,25-29,375,99,276
2017,10,Sant Martí,69,Diagonal Mar i el Front Marítim del Poblenou,25-29,93,32,61
2017,10,Sant Martí,70,el Besòs i el Maresme,25-29,318,128,190
2017,10,Sant Martí,71,Provençals del Poblenou,25-29,189,61,128
2017,10,Sant Martí,72,Sant Martí de Provençals,25-29,219,81,138
2017,10,Sant Martí,73,la Verneda i la Pau,25-29,191,95,96
2017,1,Ciutat Vella,1,el Raval,30-34,940,338,602
2017,1,Ciutat Vella,2,el Barri Gòtic,30-34,470,130,340
2017,1,Ciutat Vella,3,la Barceloneta,30-34,314,121,193
2017,1,Ciutat Vella,4,"Sant Pere, Santa Caterina i la Ribera",30-34,469,167,302
2017,2,Eixample,5,el Fort Pienc,30-34,364,178,186
2017,2,Eixample,6,la Sagrada Família,30-34,589,287,302
2017,2,Eixample,7,la Dreta de l'Eixample,30-34,530,223,307
2017,2,Eixample,8,l'Antiga Esquerra de l'Eixample,30-34,615,233,382
2017,2,Eixample,9,la Nova Esquerra de l'Eixample,30-34,734,349,385
2017,2,Eixample,10,Sant Antoni,30-34,442,204,238
2017,3,Sants-Montjuïc,11,el Poble Sec,30-34,555,262,293
2017,3,Sants-Montjuïc,12,la Marina del Prat Vermell,30-34,10,2,8
2017,3,Sants-Montjuïc,13,la Marina de Port,30-34,168,125,43
2017,3,Sants-Montjuïc,14,la Font de la Guatlla,30-34,102,54,48
2017,3,Sants-Montjuïc,15,Hostafrancs,30-34,205,130,75
2017,3,Sants-Montjuïc,16,la Bordeta,30-34,188,91,97
2017,3,Sants-Montjuïc,17,Sants - Badal,30-34,239,159,80
2017,3,Sants-Montjuïc,18,Sants,30-34,454,277,177
2017,4,Les Corts,19,les Corts,30-34,331,196,135
2017,4,Les Corts,20,la Maternitat i Sant Ramon,30-34,196,137,59
2017,4,Les Corts,21,Pedralbes,30-34,85,41,44
2017,5,Sarrià-Sant Gervasi,22,"Vallvidrera, el Tibidabo i les Planes",30-34,20,19,1
2017,5,Sarrià-Sant Gervasi,23,Sarrià,30-34,140,92,48
2017,5,Sarrià-Sant Gervasi,24,les Tres Torres,30-34,86,41,45
2017,5,Sarrià-Sant Gervasi,25,Sant Gervasi - la Bonanova,30-34,128,81,47
2017,5,Sarrià-Sant Gervasi,26,Sant Gervasi - Galvany,30-34,330,174,156
2017,5,Sarrià-Sant Gervasi,27,el Putxet i el Farró,30-34,229,135,94
2017,6,Gràcia,28,Vallcarca i els Penitents,30-34,132,65,67
2017,6,Gràcia,29,el Coll,30-34,60,23,37
2017,6,Gràcia,30,la Salut,30-34,121,52,69
2017,6,Gràcia,31,la Vila de Gràcia,30-34,760,304,456
2017,6,Gràcia,32,el Camp d'en Grassot i Gràcia Nova,30-34,328,168,160
2017,7,Horta-Guinardó,33,el Baix Guinardó,30-34,201,113,88
2017,7,Horta-Guinardó,34,Can Baró,30-34,93,39,54
2017,7,Horta-Guinardó,35,el Guinardó,30-34,306,142,164
2017,7,Horta-Guinardó,36,la Font d'en Fargues,30-34,41,28,13
2017,7,Horta-Guinardó,37,el Carmel,30-34,209,128,81
2017,7,Horta-Guinardó,38,la Teixonera,30-34,82,54,28
2017,7,Horta-Guinardó,39,Sant Genís dels Agudells,30-34,28,27,1
2017,7,Horta-Guinardó,40,Montbau,30-34,42,21,21
2017,7,Horta-Guinardó,41,la Vall d'Hebron,30-34,39,18,21
2017,7,Horta-Guinardó,42,la Clota,30-34,7,1,6
2017,7,Horta-Guinardó,43,Horta,30-34,161,84,77
2017,8,Nou Barris,44,Vilapicina i la Torre Llobeta,30-34,143,101,42
2017,8,Nou Barris,45,Porta,30-34,168,86,82
2017,8,Nou Barris,46,el Turó de la Peira,30-34,126,47,79
2017,8,Nou Barris,47,Can Peguera,30-34,3,3,0
2017,8,Nou Barris,48,la Guineueta,30-34,60,39,21
2017,8,Nou Barris,49,Canyelles,30-34,18,17,1
2017,8,Nou Barris,50,les Roquetes,30-34,126,63,63
2017,8,Nou Barris,51,Verdun,30-34,85,55,30
2017,8,Nou Barris,52,la Prosperitat,30-34,161,95,66
2017,8,Nou Barris,53,la Trinitat Nova,30-34,58,29,29
2017,8,Nou Barris,54,Torre Baró,30-34,15,11,4
2017,8,Nou Barris,55,Ciutat Meridiana,30-34,116,56,60
2017,8,Nou Barris,56,Vallbona,30-34,10,6,4
2017,9,Sant Andreu,57,la Trinitat Vella,30-34,88,65,23
2017,9,Sant Andreu,58,Baró de Viver,30-34,8,9,-1
2017,9,Sant Andreu,59,el Bon Pastor,30-34,82,44,38
2017,9,Sant Andreu,60,Sant Andreu,30-34,296,204,92
2017,9,Sant Andreu,61,la Sagrera,30-34,179,124,55
2017,9,Sant Andreu,62,el Congrés i els Indians,30-34,101,62,39
2017,9,Sant Andreu,63,Navas,30-34,177,89,88
2017,10,Sant Martí,64,el Camp de l'Arpa del Clot,30-34,389,198,191
2017,10,Sant Martí,65,el Clot,30-34,232,125,107
2017,10,Sant Martí,66,el Parc i la Llacuna del Poblenou,30-34,146,68,78
2017,10,Sant Martí,67,la Vila Olímpica del Poblenou,30-34,58,29,29
2017,10,Sant Martí,68,el Poblenou,30-34,331,153,178
2017,10,Sant Martí,69,Diagonal Mar i el Front Marítim del Poblenou,30-34,112,58,54
2017,10,Sant Martí,70,el Besòs i el Maresme,30-34,237,116,121
2017,10,Sant Martí,71,Provençals del Poblenou,30-34,174,89,85
2017,10,Sant Martí,72,Sant Martí de Provençals,30-34,188,87,101
2017,10,Sant Martí,73,la Verneda i la Pau,30-34,172,115,57
2017,1,Ciutat Vella,1,el Raval,35-39,594,296,298
2017,1,Ciutat Vella,2,el Barri Gòtic,35-39,273,113,160
2017,1,Ciutat Vella,3,la Barceloneta,35-39,181,122,59
2017,1,Ciutat Vella,4,"Sant Pere, Santa Caterina i la Ribera",35-39,282,119,163
2017,2,Eixample,5,el Fort Pienc,35-39,249,148,101
2017,2,Eixample,6,la Sagrada Família,35-39,351,226,125
2017,2,Eixample,7,la Dreta de l'Eixample,35-39,309,198,111
2017,2,Eixample,8,l'Antiga Esquerra de l'Eixample,35-39,319,170,149
2017,2,Eixample,9,la Nova Esquerra de l'Eixample,35-39,406,247,159
2017,2,Eixample,10,Sant Antoni,35-39,240,181,59
2017,3,Sants-Montjuïc,11,el Poble Sec,35-39,341,232,109
2017,3,Sants-Montjuïc,12,la Marina del Prat Vermell,35-39,2,3,-1
2017,3,Sants-Montjuïc,13,la Marina de Port,35-39,164,106,58
2017,3,Sants-Montjuïc,14,la Font de la Guatlla,35-39,68,64,4
2017,3,Sants-Montjuïc,15,Hostafrancs,35-39,107,81,26
2017,3,Sants-Montjuïc,16,la Bordeta,35-39,93,86,7
2017,3,Sants-Montjuïc,17,Sants - Badal,35-39,165,143,22
2017,3,Sants-Montjuïc,18,Sants,35-39,321,216,105
2017,4,Les Corts,19,les Corts,35-39,214,169,45
2017,4,Les Corts,20,la Maternitat i Sant Ramon,35-39,149,111,38
2017,4,Les Corts,21,Pedralbes,35-39,66,27,39
2017,5,Sarrià-Sant Gervasi,22,"Vallvidrera, el Tibidabo i les Planes",35-39,25,18,7
2017,5,Sarrià-Sant Gervasi,23,Sarrià,35-39,130,71,59
2017,5,Sarrià-Sant Gervasi,24,les Tres Torres,35-39,70,42,28
2017,5,Sarrià-Sant Gervasi,25,Sant Gervasi - la Bonanova,35-39,115,61,54
2017,5,Sarrià-Sant Gervasi,26,Sant Gervasi - Galvany,35-39,217,136,81
2017,5,Sarrià-Sant Gervasi,27,el Putxet i el Farró,35-39,140,121,19
2017,6,Gràcia,28,Vallcarca i els Penitents,35-39,80,76,4
2017,6,Gràcia,29,el Coll,35-39,31,20,11
2017,6,Gràcia,30,la Salut,35-39,82,50,32
2017,6,Gràcia,31,la Vila de Gràcia,35-39,386,306,80
2017,6,Gràcia,32,el Camp d'en Grassot i Gràcia Nova,35-39,170,142,28
2017,7,Horta-Guinardó,33,el Baix Guinardó,35-39,163,110,53
2017,7,Horta-Guinardó,34,Can Baró,35-39,62,35,27
2017,7,Horta-Guinardó,35,el Guinardó,35-39,228,136,92
2017,7,Horta-Guinardó,36,la Font d'en Fargues,35-39,22,26,-4
2017,7,Horta-Guinardó,37,el Carmel,35-39,166,119,47
2017,7,Horta-Guinardó,38,la Teixonera,35-39,50,43,7
2017,7,Horta-Guinardó,39,Sant Genís dels Agudells,35-39,43,18,25
2017,7,Horta-Guinardó,40,Montbau,35-39,27,27,0
2017,7,Horta-Guinardó,41,la Vall d'Hebron,35-39,16,13,3
2017,7,Horta-Guinardó,42,la Clota,35-39,7,0,7
2017,7,Horta-Guinardó,43,Horta,35-39,142,67,75
2017,8,Nou Barris,44,Vilapicina i la Torre Llobeta,35-39,117,83,34
2017,8,Nou Barris,45,Porta,35-39,153,90,63
2017,8,Nou Barris,46,el Turó de la Peira,35-39,86,56,30
2017,8,Nou Barris,47,Can Peguera,35-39,9,8,1
2017,8,Nou Barris,48,la Guineueta,35-39,47,39,8
2017,8,Nou Barris,49,Canyelles,35-39,16,14,2
2017,8,Nou Barris,50,les Roquetes,35-39,93,76,17
2017,8,Nou Barris,51,Verdun,35-39,62,45,17
2017,8,Nou Barris,52,la Prosperitat,35-39,126,82,44
2017,8,Nou Barris,53,la Trinitat Nova,35-39,43,45,-2
2017,8,Nou Barris,54,Torre Baró,35-39,7,12,-5
2017,8,Nou Barris,55,Ciutat Meridiana,35-39,77,46,31
2017,8,Nou Barris,56,Vallbona,35-39,8,8,0
2017,9,Sant Andreu,57,la Trinitat Vella,35-39,67,56,11
2017,9,Sant Andreu,58,Baró de Viver,35-39,9,5,4
2017,9,Sant Andreu,59,el Bon Pastor,35-39,62,55,7
2017,9,Sant Andreu,60,Sant Andreu,35-39,225,187,38
2017,9,Sant Andreu,61,la Sagrera,35-39,173,120,53
2017,9,Sant Andreu,62,el Congrés i els Indians,35-39,57,51,6
2017,9,Sant Andreu,63,Navas,35-39,103,76,27
2017,10,Sant Martí,64,el Camp de l'Arpa del Clot,35-39,235,198,37
2017,10,Sant Martí,65,el Clot,35-39,141,103,38
2017,10,Sant Martí,66,el Parc i la Llacuna del Poblenou,35-39,114,61,53
2017,10,Sant Martí,67,la Vila Olímpica del Poblenou,35-39,46,34,12
2017,10,Sant Martí,68,el Poblenou,35-39,227,154,73
2017,10,Sant Martí,69,Diagonal Mar i el Front Marítim del Poblenou,35-39,121,89,32
2017,10,Sant Martí,70,el Besòs i el Maresme,35-39,231,106,125
2017,10,Sant Martí,71,Provençals del Poblenou,35-39,115,80,35
2017,10,Sant Martí,72,Sant Martí de Provençals,35-39,107,81,26
2017,10,Sant Martí,73,la Verneda i la Pau,35-39,122,84,38
2017,1,Ciutat Vella,1,el Raval,40-44,347,200,147
2017,1,Ciutat Vella,2,el Barri Gòtic,40-44,155,91,64
2017,1,Ciutat Vella,3,la Barceloneta,40-44,101,78,23
2017,1,Ciutat Vella,4,"Sant Pere, Santa Caterina i la Ribera",40-44,143,112,31
2017,2,Eixample,5,el Fort Pienc,40-44,129,98,31
2017,2,Eixample,6,la Sagrada Família,40-44,206,147,59
2017,2,Eixample,7,la Dreta de l'Eixample,40-44,193,147,46
2017,2,Eixample,8,l'Antiga Esquerra de l'Eixample,40-44,197,146,51
2017,2,Eixample,9,la Nova Esquerra de l'Eixample,40-44,221,175,46
2017,2,Eixample,10,Sant Antoni,40-44,173,114,59
2017,3,Sants-Montjuïc,11,el Poble Sec,40-44,205,185,20
2017,3,Sants-Montjuïc,12,la Marina del Prat Vermell,40-44,4,5,-1
2017,3,Sants-Montjuïc,13,la Marina de Port,40-44,106,102,4
2017,3,Sants-Montjuïc,14,la Font de la Guatlla,40-44,45,38,7
2017,3,Sants-Montjuïc,15,Hostafrancs,40-44,69,65,4
2017,3,Sants-Montjuïc,16,la Bordeta,40-44,62,68,-6
2017,3,Sants-Montjuïc,17,Sants - Badal,40-44,119,94,25
2017,3,Sants-Montjuïc,18,Sants,40-44,197,162,35
2017,4,Les Corts,19,les Corts,40-44,199,107,92
2017,4,Les Corts,20,la Maternitat i Sant Ramon,40-44,91,88,3
2017,4,Les Corts,21,Pedralbes,40-44,73,41,32
2017,5,Sarrià-Sant Gervasi,22,"Vallvidrera, el Tibidabo i les Planes",40-44,18,19,-1
2017,5,Sarrià-Sant Gervasi,23,Sarrià,40-44,128,67,61
2017,5,Sarrià-Sant Gervasi,24,les Tres Torres,40-44,70,38,32
2017,5,Sarrià-Sant Gervasi,25,Sant Gervasi - la Bonanova,40-44,93,55,38
2017,5,Sarrià-Sant Gervasi,26,Sant Gervasi - Galvany,40-44,194,97,97
2017,5,Sarrià-Sant Gervasi,27,el Putxet i el Farró,40-44,109,85,24
2017,6,Gràcia,28,Vallcarca i els Penitents,40-44,48,46,2
2017,6,Gràcia,29,el Coll,40-44,24,19,5
2017,6,Gràcia,30,la Salut,40-44,41,40,1
2017,6,Gràcia,31,la Vila de Gràcia,40-44,219,162,57
2017,6,Gràcia,32,el Camp d'en Grassot i Gràcia Nova,40-44,114,82,32
2017,7,Horta-Guinardó,33,el Baix Guinardó,40-44,75,72,3
2017,7,Horta-Guinardó,34,Can Baró,40-44,35,35,0
2017,7,Horta-Guinardó,35,el Guinardó,40-44,125,117,8
2017,7,Horta-Guinardó,36,la Font d'en Fargues,40-44,32,15,17
2017,7,Horta-Guinardó,37,el Carmel,40-44,101,86,15
2017,7,Horta-Guinardó,38,la Teixonera,40-44,37,35,2
2017,7,Horta-Guinardó,39,Sant Genís dels Agudells,40-44,20,18,2
2017,7,Horta-Guinardó,40,Montbau,40-44,13,15,-2
2017,7,Horta-Guinardó,41,la Vall d'Hebron,40-44,13,13,0
2017,7,Horta-Guinardó,42,la Clota,40-44,3,4,-1
2017,7,Horta-Guinardó,43,Horta,40-44,96,65,31
2017,8,Nou Barris,44,Vilapicina i la Torre Llobeta,40-44,85,60,25
2017,8,Nou Barris,45,Porta,40-44,108,68,40
2017,8,Nou Barris,46,el Turó de la Peira,40-44,61,41,20
2017,8,Nou Barris,47,Can Peguera,40-44,3,2,1
2017,8,Nou Barris,48,la Guineueta,40-44,36,31,5
2017,8,Nou Barris,49,Canyelles,40-44,16,8,8
2017,8,Nou Barris,50,les Roquetes,40-44,63,53,10
2017,8,Nou Barris,51,Verdun,40-44,48,31,17
2017,8,Nou Barris,52,la Prosperitat,40-44,94,58,36
2017,8,Nou Barris,53,la Trinitat Nova,40-44,46,32,14
2017,8,Nou Barris,54,Torre Baró,40-44,9,13,-4
2017,8,Nou Barris,55,Ciutat Meridiana,40-44,65,43,22
2017,8,Nou Barris,56,Vallbona,40-44,11,6,5
2017,9,Sant Andreu,57,la Trinitat Vella,40-44,58,48,10
2017,9,Sant Andreu,58,Baró de Viver,40-44,8,7,1
2017,9,Sant Andreu,59,el Bon Pastor,40-44,67,37,30
2017,9,Sant Andreu,60,Sant Andreu,40-44,179,129,50
2017,9,Sant Andreu,61,la Sagrera,40-44,99,74,25
2017,9,Sant Andreu,62,el Congrés i els Indians,40-44,50,38,12
2017,9,Sant Andreu,63,Navas,40-44,85,69,16
2017,10,Sant Martí,64,el Camp de l'Arpa del Clot,40-44,147,123,24
2017,10,Sant Martí,65,el Clot,40-44,91,54,37
2017,10,Sant Martí,66,el Parc i la Llacuna del Poblenou,40-44,49,51,-2
2017,10,Sant Martí,67,la Vila Olímpica del Poblenou,40-44,43,34,9
2017,10,Sant Martí,68,el Poblenou,40-44,152,105,47
2017,10,Sant Martí,69,Diagonal Mar i el Front Marítim del Poblenou,40-44,82,67,15
2017,10,Sant Martí,70,el Besòs i el Maresme,40-44,195,90,105
2017,10,Sant Martí,71,Provençals del Poblenou,40-44,71,78,-7
2017,10,Sant Martí,72,Sant Martí de Provençals,40-44,72,68,4
2017,10,Sant Martí,73,la Verneda i la Pau,40-44,110,75,35
2017,1,Ciutat Vella,1,el Raval,45-49,229,136,93
2017,1,Ciutat Vella,2,el Barri Gòtic,45-49,102,43,59
2017,1,Ciutat Vella,3,la Barceloneta,45-49,72,36,36
2017,1,Ciutat Vella,4,"Sant Pere, Santa Caterina i la Ribera",45-49,87,57,30
2017,2,Eixample,5,el Fort Pienc,45-49,90,74,16
2017,2,Eixample,6,la Sagrada Família,45-49,134,85,49
2017,2,Eixample,7,la Dreta de l'Eixample,45-49,154,85,69
2017,2,Eixample,8,l'Antiga Esquerra de l'Eixample,45-49,151,78,73
2017,2,Eixample,9,la Nova Esquerra de l'Eixample,45-49,164,126,38
2017,2,Eixample,10,Sant Antoni,45-49,94,86,8
2017,3,Sants-Montjuïc,11,el Poble Sec,45-49,113,117,-4
2017,3,Sants-Montjuïc,12,la Marina del Prat Vermell,45-49,3,5,-2
2017,3,Sants-Montjuïc,13,la Marina de Port,45-49,101,79,22
2017,3,Sants-Montjuïc,14,la Font de la Guatlla,45-49,33,33,0
2017,3,Sants-Montjuïc,15,Hostafrancs,45-49,58,32,26
2017,3,Sants-Montjuïc,16,la Bordeta,45-49,37,45,-8
2017,3,Sants-Montjuïc,17,Sants - Badal,45-49,68,64,4
2017,3,Sants-Montjuïc,18,Sants,45-49,118,101,17
2017,4,Les Corts,19,les Corts,45-49,93,112,-19
2017,4,Les Corts,20,la Maternitat i Sant Ramon,45-49,64,61,3
2017,4,Les Corts,21,Pedralbes,45-49,57,28,29
2017,5,Sarrià-Sant Gervasi,22,"Vallvidrera, el Tibidabo i les Planes",45-49,18,11,7
2017,5,Sarrià-Sant Gervasi,23,Sarrià,45-49,77,35,42
2017,5,Sarrià-Sant Gervasi,24,les Tres Torres,45-49,45,26,19
2017,5,Sarrià-Sant Gervasi,25,Sant Gervasi - la Bonanova,45-49,80,43,37
2017,5,Sarrià-Sant Gervasi,26,Sant Gervasi - Galvany,45-49,168,89,79
2017,5,Sarrià-Sant Gervasi,27,el Putxet i el Farró,45-49,80,51,29
2017,6,Gràcia,28,Vallcarca i els Penitents,45-49,33,29,4
2017,6,Gràcia,29,el Coll,45-49,13,12,1
2017,6,Gràcia,30,la Salut,45-49,28,18,10
2017,6,Gràcia,31,la Vila de Gràcia,45-49,121,103,18
2017,6,Gràcia,32,el Camp d'en Grassot i Gràcia Nova,45-49,60,65,-5
2017,7,Horta-Guinardó,33,el Baix Guinardó,45-49,56,40,16
2017,7,Horta-Guinardó,34,Can Baró,45-49,16,19,-3
2017,7,Horta-Guinardó,35,el Guinardó,45-49,94,75,19
2017,7,Horta-Guinardó,36,la Font d'en Fargues,45-49,7,4,3
2017,7,Horta-Guinardó,37,el Carmel,45-49,67,35,32
2017,7,Horta-Guinardó,38,la Teixonera,45-49,17,36,-19
2017,7,Horta-Guinardó,39,Sant Genís dels Agudells,45-49,14,10,4
2017,7,Horta-Guinardó,40,Montbau,45-49,15,12,3
2017,7,Horta-Guinardó,41,la Vall d'Hebron,45-49,11,8,3
2017,7,Horta-Guinardó,42,la Clota,45-49,2,1,1
2017,7,Horta-Guinardó,43,Horta,45-49,60,39,21
2017,8,Nou Barris,44,Vilapicina i la Torre Llobeta,45-49,60,45,15
2017,8,Nou Barris,45,Porta,45-49,108,52,56
2017,8,Nou Barris,46,el Turó de la Peira,45-49,44,30,14
2017,8,Nou Barris,47,Can Peguera,45-49,5,5,0
2017,8,Nou Barris,48,la Guineueta,45-49,38,27,11
2017,8,Nou Barris,49,Canyelles,45-49,8,3,5
2017,8,Nou Barris,50,les Roquetes,45-49,55,32,23
2017,8,Nou Barris,51,Verdun,45-49,36,19,17
2017,8,Nou Barris,52,la Prosperitat,45-49,74,48,26
2017,8,Nou Barris,53,la Trinitat Nova,45-49,23,19,4
2017,8,Nou Barris,54,Torre Baró,45-49,5,2,3
2017,8,Nou Barris,55,Ciutat Meridiana,45-49,45,32,13
2017,8,Nou Barris,56,Vallbona,45-49,3,2,1
2017,9,Sant Andreu,57,la Trinitat Vella,45-49,36,26,10
2017,9,Sant Andreu,58,Baró de Viver,45-49,5,6,-1
2017,9,Sant Andreu,59,el Bon Pastor,45-49,35,27,8
2017,9,Sant Andreu,60,Sant Andreu,45-49,108,96,12
2017,9,Sant Andreu,61,la Sagrera,45-49,66,42,24
2017,9,Sant Andreu,62,el Congrés i els Indians,45-49,43,28,15
2017,9,Sant Andreu,63,Navas,45-49,47,34,13
2017,10,Sant Martí,64,el Camp de l'Arpa del Clot,45-49,91,69,22
2017,10,Sant Martí,65,el Clot,45-49,71,50,21
2017,10,Sant Martí,66,el Parc i la Llacuna del Poblenou,45-49,28,32,-4
2017,10,Sant Martí,67,la Vila Olímpica del Poblenou,45-49,23,20,3
2017,10,Sant Martí,68,el Poblenou,45-49,77,74,3
2017,10,Sant Martí,69,Diagonal Mar i el Front Marítim del Poblenou,45-49,38,28,10
2017,10,Sant Martí,70,el Besòs i el Maresme,45-49,106,66,40
2017,10,Sant Martí,71,Provençals del Poblenou,45-49,49,46,3
2017,10,Sant Martí,72,Sant Martí de Provençals,45-49,62,49,13
2017,10,Sant Martí,73,la Verneda i la Pau,45-49,72,61,11
2017,1,Ciutat Vella,1,el Raval,50-54,132,88,44
2017,1,Ciutat Vella,2,el Barri Gòtic,50-54,81,38,43
2017,1,Ciutat Vella,3,la Barceloneta,50-54,53,34,19
2017,1,Ciutat Vella,4,"Sant Pere, Santa Caterina i la Ribera",50-54,73,45,28
2017,2,Eixample,5,el Fort Pienc,50-54,82,62,20
2017,2,Eixample,6,la Sagrada Família,50-54,115,88,27
2017,2,Eixample,7,la Dreta de l'Eixample,50-54,114,57,57
2017,2,Eixample,8,l'Antiga Esquerra de l'Eixample,50-54,115,66,49
2017,2,Eixample,9,la Nova Esquerra de l'Eixample,50-54,124,89,35
2017,2,Eixample,10,Sant Antoni,50-54,79,74,5
2017,3,Sants-Montjuïc,11,el Poble Sec,50-54,100,81,19
2017,3,Sants-Montjuïc,12,la Marina del Prat Vermell,50-54,1,2,-1
2017,3,Sants-Montjuïc,13,la Marina de Port,50-54,63,53,10
2017,3,Sants-Montjuïc,14,la Font de la Guatlla,50-54,20,12,8
2017,3,Sants-Montjuïc,15,Hostafrancs,50-54,29,23,6
2017,3,Sants-Montjuïc,16,la Bordeta,50-54,33,36,-3
2017,3,Sants-Montjuïc,17,Sants - Badal,50-54,55,38,17
2017,3,Sants-Montjuïc,18,Sants,50-54,106,83,23
2017,4,Les Corts,19,les Corts,50-54,79,74,5
2017,4,Les Corts,20,la Maternitat i Sant Ramon,50-54,40,38,2
2017,4,Les Corts,21,Pedralbes,50-54,32,31,1
2017,5,Sarrià-Sant Gervasi,22,"Vallvidrera, el Tibidabo i les Planes",50-54,11,7,4
2017,5,Sarrià-Sant Gervasi,23,Sarrià,50-54,58,41,17
2017,5,Sarrià-Sant Gervasi,24,les Tres Torres,50-54,25,37,-12
2017,5,Sarrià-Sant Gervasi,25,Sant Gervasi - la Bonanova,50-54,59,45,14
2017,5,Sarrià-Sant Gervasi,26,Sant Gervasi - Galvany,50-54,129,70,59
2017,5,Sarrià-Sant Gervasi,27,el Putxet i el Farró,50-54,61,41,20
2017,6,Gràcia,28,Vallcarca i els Penitents,50-54,34,20,14
2017,6,Gràcia,29,el Coll,50-54,10,14,-4
2017,6,Gràcia,30,la Salut,50-54,16,22,-6
2017,6,Gràcia,31,la Vila de Gràcia,50-54,83,82,1
2017,6,Gràcia,32,el Camp d'en Grassot i Gràcia Nova,50-54,50,34,16
2017,7,Horta-Guinardó,33,el Baix Guinardó,50-54,33,38,-5
2017,7,Horta-Guinardó,34,Can Baró,50-54,16,19,-3
2017,7,Horta-Guinardó,35,el Guinardó,50-54,86,50,36
2017,7,Horta-Guinardó,36,la Font d'en Fargues,50-54,17,10,7
2017,7,Horta-Guinardó,37,el Carmel,50-54,52,48,4
2017,7,Horta-Guinardó,38,la Teixonera,50-54,21,14,7
2017,7,Horta-Guinardó,39,Sant Genís dels Agudells,50-54,24,11,13
2017,7,Horta-Guinardó,40,Montbau,50-54,7,4,3
2017,7,Horta-Guinardó,41,la Vall d'Hebron,50-54,10,6,4
2017,7,Horta-Guinardó,42,la Clota,50-54,2,0,2
2017,7,Horta-Guinardó,43,Horta,50-54,41,44,-3
2017,8,Nou Barris,44,Vilapicina i la Torre Llobeta,50-54,46,38,8
2017,8,Nou Barris,45,Porta,50-54,72,45,27
2017,8,Nou Barris,46,el Turó de la Peira,50-54,31,33,-2
2017,8,Nou Barris,47,Can Peguera,50-54,6,5,1
2017,8,Nou Barris,48,la Guineueta,50-54,39,20,19
2017,8,Nou Barris,49,Canyelles,50-54,7,7,0
2017,8,Nou Barris,50,les Roquetes,50-54,42,40,2
2017,8,Nou Barris,51,Verdun,50-54,20,21,-1
2017,8,Nou Barris,52,la Prosperitat,50-54,53,25,28
2017,8,Nou Barris,53,la Trinitat Nova,50-54,10,9,1
2017,8,Nou Barris,54,Torre Baró,50-54,9,4,5
2017,8,Nou Barris,55,Ciutat Meridiana,50-54,49,22,27
2017,8,Nou Barris,56,Vallbona,50-54,3,2,1
2017,9,Sant Andreu,57,la Trinitat Vella,50-54,29,23,6
2017,9,Sant Andreu,58,Baró de Viver,50-54,3,6,-3
2017,9,Sant Andreu,59,el Bon Pastor,50-54,30,23,7
2017,9,Sant Andreu,60,Sant Andreu,50-54,92,65,27
2017,9,Sant Andreu,61,la Sagrera,50-54,59,43,16
2017,9,Sant Andreu,62,el Congrés i els Indians,50-54,29,26,3
2017,9,Sant Andreu,63,Navas,50-54,31,34,-3
2017,10,Sant Martí,64,el Camp de l'Arpa del Clot,50-54,68,53,15
2017,10,Sant Martí,65,el Clot,50-54,40,49,-9
2017,10,Sant Martí,66,el Parc i la Llacuna del Poblenou,50-54,14,23,-9
2017,10,Sant Martí,67,la Vila Olímpica del Poblenou,50-54,22,13,9
2017,10,Sant Martí,68,el Poblenou,50-54,57,55,2
2017,10,Sant Martí,69,Diagonal Mar i el Front Marítim del Poblenou,50-54,47,19,28
2017,10,Sant Martí,70,el Besòs i el Maresme,50-54,81,47,34
2017,10,Sant Martí,71,Provençals del Poblenou,50-54,50,26,24
2017,10,Sant Martí,72,Sant Martí de Provençals,50-54,43,39,4
2017,10,Sant Martí,73,la Verneda i la Pau,50-54,63,34,29
2017,1,Ciutat Vella,1,el Raval,55-59,95,61,34
2017,1,Ciutat Vella,2,el Barri Gòtic,55-59,55,21,34
2017,1,Ciutat Vella,3,la Barceloneta,55-59,38,18,20
2017,1,Ciutat Vella,4,"Sant Pere, Santa Caterina i la Ribera",55-59,32,34,-2
2017,2,Eixample,5,el Fort Pienc,55-59,46,42,4
2017,2,Eixample,6,la Sagrada Família,55-59,88,80,8
2017,2,Eixample,7,la Dreta de l'Eixample,55-59,89,60,29
2017,2,Eixample,8,l'Antiga Esquerra de l'Eixample,55-59,92,40,52
2017,2,Eixample,9,la Nova Esquerra de l'Eixample,55-59,79,63,16
2017,2,Eixample,10,Sant Antoni,55-59,51,44,7
2017,3,Sants-Montjuïc,11,el Poble Sec,55-59,68,49,19
2017,3,Sants-Montjuïc,12,la Marina del Prat Vermell,55-59,0,1,-1
2017,3,Sants-Montjuïc,13,la Marina de Port,55-59,51,30,21
2017,3,Sants-Montjuïc,14,la Font de la Guatlla,55-59,9,15,-6
2017,3,Sants-Montjuïc,15,Hostafrancs,55-59,23,25,-2
2017,3,Sants-Montjuïc,16,la Bordeta,55-59,22,18,4
2017,3,Sants-Montjuïc,17,Sants - Badal,55-59,48,25,23
2017,3,Sants-Montjuïc,18,Sants,55-59,68,54,14
2017,4,Les Corts,19,les Corts,55-59,49,50,-1
2017,4,Les Corts,20,la Maternitat i Sant Ramon,55-59,32,23,9
2017,4,Les Corts,21,Pedralbes,55-59,22,20,2
2017,5,Sarrià-Sant Gervasi,22,"Vallvidrera, el Tibidabo i les Planes",55-59,4,7,-3
2017,5,Sarrià-Sant Gervasi,23,Sarrià,55-59,39,33,6
2017,5,Sarrià-Sant Gervasi,24,les Tres Torres,55-59,19,14,5
2017,5,Sarrià-Sant Gervasi,25,Sant Gervasi - la Bonanova,55-59,31,22,9
2017,5,Sarrià-Sant Gervasi,26,Sant Gervasi - Galvany,55-59,100,65,35
2017,5,Sarrià-Sant Gervasi,27,el Putxet i el Farró,55-59,32,35,-3
2017,6,Gràcia,28,Vallcarca i els Penitents,55-59,28,29,-1
2017,6,Gràcia,29,el Coll,55-59,8,8,0
2017,6,Gràcia,30,la Salut,55-59,12,17,-5
2017,6,Gràcia,31,la Vila de Gràcia,55-59,69,47,22
2017,6,Gràcia,32,el Camp d'en Grassot i Gràcia Nova,55-59,37,33,4
2017,7,Horta-Guinardó,33,el Baix Guinardó,55-59,44,25,19
2017,7,Horta-Guinardó,34,Can Baró,55-59,14,13,1
2017,7,Horta-Guinardó,35,el Guinardó,55-59,44,44,0
2017,7,Horta-Guinardó,36,la Font d'en Fargues,55-59,7,8,-1
2017,7,Horta-Guinardó,37,el Carmel,55-59,35,34,1
2017,7,Horta-Guinardó,38,la Teixonera,55-59,14,3,11
2017,7,Horta-Guinardó,39,Sant Genís dels Agudells,55-59,12,8,4
2017,7,Horta-Guinardó,40,Montbau,55-59,3,8,-5
2017,7,Horta-Guinardó,41,la Vall d'Hebron,55-59,10,4,6
2017,7,Horta-Guinardó,42,la Clota,55-59,0,2,-2
2017,7,Horta-Guinardó,43,Horta,55-59,33,29,4
2017,8,Nou Barris,44,Vilapicina i la Torre Llobeta,55-59,37,35,2
2017,8,Nou Barris,45,Porta,55-59,54,27,27
2017,8,Nou Barris,46,el Turó de la Peira,55-59,34,19,15
2017,8,Nou Barris,47,Can Peguera,55-59,1,2,-1
2017,8,Nou Barris,48,la Guineueta,55-59,19,12,7
2017,8,Nou Barris,49,Canyelles,55-59,7,10,-3
2017,8,Nou Barris,50,les Roquetes,55-59,29,26,3
2017,8,Nou Barris,51,Verdun,55-59,13,9,4
2017,8,Nou Barris,52,la Prosperitat,55-59,31,31,0
2017,8,Nou Barris,53,la Trinitat Nova,55-59,14,10,4
2017,8,Nou Barris,54,Torre Baró,55-59,0,2,-2
2017,8,Nou Barris,55,Ciutat Meridiana,55-59,22,7,15
2017,8,Nou Barris,56,Vallbona,55-59,1,3,-2
2017,9,Sant Andreu,57,la Trinitat Vella,55-59,24,12,12
2017,9,Sant Andreu,58,Baró de Viver,55-59,3,8,-5
2017,9,Sant Andreu,59,el Bon Pastor,55-59,20,18,2
2017,9,Sant Andreu,60,Sant Andreu,55-59,70,54,16
2017,9,Sant Andreu,61,la Sagrera,55-59,39,30,9
2017,9,Sant Andreu,62,el Congrés i els Indians,55-59,19,18,1
2017,9,Sant Andreu,63,Navas,55-59,27,29,-2
2017,10,Sant Martí,64,el Camp de l'Arpa del Clot,55-59,52,31,21
2017,10,Sant Martí,65,el Clot,55-59,29,33,-4
2017,10,Sant Martí,66,el Parc i la Llacuna del Poblenou,55-59,25,11,14
2017,10,Sant Martí,67,la Vila Olímpica del Poblenou,55-59,13,17,-4
2017,10,Sant Martí,68,el Poblenou,55-59,33,39,-6
2017,10,Sant Martí,69,Diagonal Mar i el Front Marítim del Poblenou,55-59,27,22,5
2017,10,Sant Martí,70,el Besòs i el Maresme,55-59,54,35,19
2017,10,Sant Martí,71,Provençals del Poblenou,55-59,31,24,7
2017,10,Sant Martí,72,Sant Martí de Provençals,55-59,35,36,-1
2017,10,Sant Martí,73,la Verneda i la Pau,55-59,39,26,13
2017,1,Ciutat Vella,1,el Raval,60-64,60,43,17
2017,1,Ciutat Vella,2,el Barri Gòtic,60-64,33,23,10
2017,1,Ciutat Vella,3,la Barceloneta,60-64,30,21,9
2017,1,Ciutat Vella,4,"Sant Pere, Santa Caterina i la Ribera",60-64,37,28,9
2017,2,Eixample,5,el Fort Pienc,60-64,36,36,0
2017,2,Eixample,6,la Sagrada Família,60-64,77,54,23
2017,2,Eixample,7,la Dreta de l'Eixample,60-64,73,61,12
2017,2,Eixample,8,l'Antiga Esquerra de l'Eixample,60-64,65,57,8
2017,2,Eixample,9,la Nova Esquerra de l'Eixample,60-64,73,60,13
2017,2,Eixample,10,Sant Antoni,60-64,39,38,1
2017,3,Sants-Montjuïc,11,el Poble Sec,60-64,55,32,23
2017,3,Sants-Montjuïc,12,la Marina del Prat Vermell,60-64,0,1,-1
2017,3,Sants-Montjuïc,13,la Marina de Port,60-64,36,29,7
2017,3,Sants-Montjuïc,14,la Font de la Guatlla,60-64,12,16,-4
2017,3,Sants-Montjuïc,15,Hostafrancs,60-64,22,18,4
2017,3,Sants-Montjuïc,16,la Bordeta,60-64,20,24,-4
2017,3,Sants-Montjuïc,17,Sants - Badal,60-64,30,24,6
2017,3,Sants-Montjuïc,18,Sants,60-64,48,57,-9
2017,4,Les Corts,19,les Corts,60-64,62,47,15
2017,4,Les Corts,20,la Maternitat i Sant Ramon,60-64,29,24,5
2017,4,Les Corts,21,Pedralbes,60-64,21,18,3
2017,5,Sarrià-Sant Gervasi,22,"Vallvidrera, el Tibidabo i les Planes",60-64,5,1,4
2017,5,Sarrià-Sant Gervasi,23,Sarrià,60-64,26,21,5
2017,5,Sarrià-Sant Gervasi,24,les Tres Torres,60-64,14,16,-2
2017,5,Sarrià-Sant Gervasi,25,Sant Gervasi - la Bonanova,60-64,24,27,-3
2017,5,Sarrià-Sant Gervasi,26,Sant Gervasi - Galvany,60-64,64,58,6
2017,5,Sarrià-Sant Gervasi,27,el Putxet i el Farró,60-64,31,38,-7
2017,6,Gràcia,28,Vallcarca i els Penitents,60-64,18,16,2
2017,6,Gràcia,29,el Coll,60-64,7,9,-2
2017,6,Gràcia,30,la Salut,60-64,13,10,3
2017,6,Gràcia,31,la Vila de Gràcia,60-64,47,50,-3
2017,6,Gràcia,32,el Camp d'en Grassot i Gràcia Nova,60-64,28,37,-9
2017,7,Horta-Guinardó,33,el Baix Guinardó,60-64,33,24,9
2017,7,Horta-Guinardó,34,Can Baró,60-64,10,7,3
2017,7,Horta-Guinardó,35,el Guinardó,60-64,39,30,9
2017,7,Horta-Guinardó,36,la Font d'en Fargues,60-64,13,8,5
2017,7,Horta-Guinardó,37,el Carmel,60-64,26,32,-6
2017,7,Horta-Guinardó,38,la Teixonera,60-64,16,8,8
2017,7,Horta-Guinardó,39,Sant Genís dels Agudells,60-64,10,7,3
2017,7,Horta-Guinardó,40,Montbau,60-64,4,2,2
2017,7,Horta-Guinardó,41,la Vall d'Hebron,60-64,0,7,-7
2017,7,Horta-Guinardó,42,la Clota,60-64,0,2,-2
2017,7,Horta-Guinardó,43,Horta,60-64,21,18,3
2017,8,Nou Barris,44,Vilapicina i la Torre Llobeta,60-64,21,23,-2
2017,8,Nou Barris,45,Porta,60-64,34,20,14
2017,8,Nou Barris,46,el Turó de la Peira,60-64,17,13,4
2017,8,Nou Barris,47,Can Peguera,60-64,1,2,-1
2017,8,Nou Barris,48,la Guineueta,60-64,14,18,-4
2017,8,Nou Barris,49,Canyelles,60-64,8,4,4
2017,8,Nou Barris,50,les Roquetes,60-64,20,18,2
2017,8,Nou Barris,51,Verdun,60-64,11,12,-1
2017,8,Nou Barris,52,la Prosperitat,60-64,25,14,11
2017,8,Nou Barris,53,la Trinitat Nova,60-64,14,8,6
2017,8,Nou Barris,54,Torre Baró,60-64,1,1,0
2017,8,Nou Barris,55,Ciutat Meridiana,60-64,19,19,0
2017,8,Nou Barris,56,Vallbona,60-64,1,1,0
2017,9,Sant Andreu,57,la Trinitat Vella,60-64,16,13,3
2017,9,Sant Andreu,58,Baró de Viver,60-64,1,3,-2
2017,9,Sant Andreu,59,el Bon Pastor,60-64,15,11,4
2017,9,Sant Andreu,60,Sant Andreu,60-64,51,38,13
2017,9,Sant Andreu,61,la Sagrera,60-64,45,29,16
2017,9,Sant Andreu,62,el Congrés i els Indians,60-64,11,10,1
2017,9,Sant Andreu,63,Navas,60-64,21,19,2
2017,10,Sant Martí,64,el Camp de l'Arpa del Clot,60-64,39,45,-6
2017,10,Sant Martí,65,el Clot,60-64,26,30,-4
2017,10,Sant Martí,66,el Parc i la Llacuna del Poblenou,60-64,17,14,3
2017,10,Sant Martí,67,la Vila Olímpica del Poblenou,60-64,12,14,-2
2017,10,Sant Martí,68,el Poblenou,60-64,38,18,20
2017,10,Sant Martí,69,Diagonal Mar i el Front Marítim del Poblenou,60-64,14,12,2
2017,10,Sant Martí,70,el Besòs i el Maresme,60-64,54,28,26
2017,10,Sant Martí,71,Provençals del Poblenou,60-64,24,21,3
2017,10,Sant Martí,72,Sant Martí de Provençals,60-64,29,24,5
2017,10,Sant Martí,73,la Verneda i la Pau,60-64,42,26,16
2017,1,Ciutat Vella,1,el Raval,65-69,35,44,-9
2017,1,Ciutat Vella,2,el Barri Gòtic,65-69,22,16,6
2017,1,Ciutat Vella,3,la Barceloneta,65-69,9,12,-3
2017,1,Ciutat Vella,4,"Sant Pere, Santa Caterina i la Ribera",65-69,21,16,5
2017,2,Eixample,5,el Fort Pienc,65-69,27,26,1
2017,2,Eixample,6,la Sagrada Família,65-69,55,47,8
2017,2,Eixample,7,la Dreta de l'Eixample,65-69,35,57,-22
2017,2,Eixample,8,l'Antiga Esquerra de l'Eixample,65-69,48,44,4
2017,2,Eixample,9,la Nova Esquerra de l'Eixample,65-69,77,70,7
2017,2,Eixample,10,Sant Antoni,65-69,50,30,20
2017,3,Sants-Montjuïc,11,el Poble Sec,65-69,21,34,-13
2017,3,Sants-Montjuïc,12,la Marina del Prat Vermell,65-69,1,1,0
2017,3,Sants-Montjuïc,13,la Marina de Port,65-69,31,25,6
2017,3,Sants-Montjuïc,14,la Font de la Guatlla,65-69,9,9,0
2017,3,Sants-Montjuïc,15,Hostafrancs,65-69,6,19,-13
2017,3,Sants-Montjuïc,16,la Bordeta,65-69,14,25,-11
2017,3,Sants-Montjuïc,17,Sants - Badal,65-69,15,20,-5
2017,3,Sants-Montjuïc,18,Sants,65-69,48,47,1
2017,4,Les Corts,19,les Corts,65-69,47,58,-11
2017,4,Les Corts,20,la Maternitat i Sant Ramon,65-69,24,20,4
2017,4,Les Corts,21,Pedralbes,65-69,15,16,-1
2017,5,Sarrià-Sant Gervasi,22,"Vallvidrera, el Tibidabo i les Planes",65-69,6,3,3
2017,5,Sarrià-Sant Gervasi,23,Sarrià,65-69,19,11,8
2017,5,Sarrià-Sant Gervasi,24,les Tres Torres,65-69,15,11,4
2017,5,Sarrià-Sant Gervasi,25,Sant Gervasi - la Bonanova,65-69,22,27,-5
2017,5,Sarrià-Sant Gervasi,26,Sant Gervasi - Galvany,65-69,42,47,-5
2017,5,Sarrià-Sant Gervasi,27,el Putxet i el Farró,65-69,21,21,0
2017,6,Gràcia,28,Vallcarca i els Penitents,65-69,13,17,-4
2017,6,Gràcia,29,el Coll,65-69,3,10,-7
2017,6,Gràcia,30,la Salut,65-69,6,13,-7
2017,6,Gràcia,31,la Vila de Gràcia,65-69,39,39,0
2017,6,Gràcia,32,el Camp d'en Grassot i Gràcia Nova,65-69,42,37,5
2017,7,Horta-Guinardó,33,el Baix Guinardó,65-69,28,25,3
2017,7,Horta-Guinardó,34,Can Baró,65-69,5,6,-1
2017,7,Horta-Guinardó,35,el Guinardó,65-69,27,29,-2
2017,7,Horta-Guinardó,36,la Font d'en Fargues,65-69,5,12,-7
2017,7,Horta-Guinardó,37,el Carmel,65-69,18,36,-18
2017,7,Horta-Guinardó,38,la Teixonera,65-69,10,16,-6
2017,7,Horta-Guinardó,39,Sant Genís dels Agudells,65-69,6,5,1
2017,7,Horta-Guinardó,40,Montbau,65-69,2,2,0
2017,7,Horta-Guinardó,41,la Vall d'Hebron,65-69,0,2,-2
2017,7,Horta-Guinardó,42,la Clota,65-69,0,1,-1
2017,7,Horta-Guinardó,43,Horta,65-69,15,30,-15
2017,8,Nou Barris,44,Vilapicina i la Torre Llobeta,65-69,17,20,-3
2017,8,Nou Barris,45,Porta,65-69,18,20,-2
2017,8,Nou Barris,46,el Turó de la Peira,65-69,17,12,5
2017,8,Nou Barris,47,Can Peguera,65-69,1,2,-1
2017,8,Nou Barris,48,la Guineueta,65-69,4,8,-4
2017,8,Nou Barris,49,Canyelles,65-69,3,10,-7
2017,8,Nou Barris,50,les Roquetes,65-69,17,15,2
2017,8,Nou Barris,51,Verdun,65-69,16,10,6
2017,8,Nou Barris,52,la Prosperitat,65-69,22,12,10
2017,8,Nou Barris,53,la Trinitat Nova,65-69,8,6,2
2017,8,Nou Barris,54,Torre Baró,65-69,2,3,-1
2017,8,Nou Barris,55,Ciutat Meridiana,65-69,7,10,-3
2017,8,Nou Barris,56,Vallbona,65-69,0,0,0
2017,9,Sant Andreu,57,la Trinitat Vella,65-69,7,9,-2
2017,9,Sant Andreu,58,Baró de Viver,65-69,4,4,0
2017,9,Sant Andreu,59,el Bon Pastor,65-69,4,6,-2
2017,9,Sant Andreu,60,Sant Andreu,65-69,48,68,-20
2017,9,Sant Andreu,61,la Sagrera,65-69,28,25,3
2017,9,Sant Andreu,62,el Congrés i els Indians,65-69,14,13,1
2017,9,Sant Andreu,63,Navas,65-69,11,21,-10
2017,10,Sant Martí,64,el Camp de l'Arpa del Clot,65-69,44,31,13
2017,10,Sant Martí,65,el Clot,65-69,16,17,-1
2017,10,Sant Martí,66,el Parc i la Llacuna del Poblenou,65-69,19,10,9
2017,10,Sant Martí,67,la Vila Olímpica del Poblenou,65-69,10,13,-3
2017,10,Sant Martí,68,el Poblenou,65-69,36,24,12
2017,10,Sant Martí,69,Diagonal Mar i el Front Marítim del Poblenou,65-69,16,8,8
2017,10,Sant Martí,70,el Besòs i el Maresme,65-69,23,15,8
2017,10,Sant Martí,71,Provençals del Poblenou,65-69,12,21,-9
2017,10,Sant Martí,72,Sant Martí de Provençals,65-69,15,18,-3
2017,10,Sant Martí,73,la Verneda i la Pau,65-69,31,27,4
2017,1,Ciutat Vella,1,el Raval,70-74,16,33,-17
2017,1,Ciutat Vella,2,el Barri Gòtic,70-74,9,13,-4
2017,1,Ciutat Vella,3,la Barceloneta,70-74,6,14,-8
2017,1,Ciutat Vella,4,"Sant Pere, Santa Caterina i la Ribera",70-74,11,16,-5
2017,2,Eixample,5,el Fort Pienc,70-74,30,20,10
2017,2,Eixample,6,la Sagrada Família,70-74,40,28,12
2017,2,Eixample,7,la Dreta de l'Eixample,70-74,26,38,-12
2017,2,Eixample,8,l'Antiga Esquerra de l'Eixample,70-74,42,25,17
2017,2,Eixample,9,la Nova Esquerra de l'Eixample,70-74,40,45,-5
2017,2,Eixample,10,Sant Antoni,70-74,31,26,5
2017,3,Sants-Montjuïc,11,el Poble Sec,70-74,16,32,-16
2017,3,Sants-Montjuïc,12,la Marina del Prat Vermell,70-74,0,1,-1
2017,3,Sants-Montjuïc,13,la Marina de Port,70-74,15,14,1
2017,3,Sants-Montjuïc,14,la Font de la Guatlla,70-74,5,12,-7
2017,3,Sants-Montjuïc,15,Hostafrancs,70-74,4,6,-2
2017,3,Sants-Montjuïc,16,la Bordeta,70-74,9,17,-8
2017,3,Sants-Montjuïc,17,Sants - Badal,70-74,16,18,-2
2017,3,Sants-Montjuïc,18,Sants,70-74,19,24,-5
2017,4,Les Corts,19,les Corts,70-74,30,40,-10
2017,4,Les Corts,20,la Maternitat i Sant Ramon,70-74,7,29,-22
2017,4,Les Corts,21,Pedralbes,70-74,6,13,-7
2017,5,Sarrià-Sant Gervasi,22,"Vallvidrera, el Tibidabo i les Planes",70-74,1,3,-2
2017,5,Sarrià-Sant Gervasi,23,Sarrià,70-74,16,15,1
2017,5,Sarrià-Sant Gervasi,24,les Tres Torres,70-74,8,12,-4
2017,5,Sarrià-Sant Gervasi,25,Sant Gervasi - la Bonanova,70-74,27,21,6
2017,5,Sarrià-Sant Gervasi,26,Sant Gervasi - Galvany,70-74,33,26,7
2017,5,Sarrià-Sant Gervasi,27,el Putxet i el Farró,70-74,20,25,-5
2017,6,Gràcia,28,Vallcarca i els Penitents,70-74,9,15,-6
2017,6,Gràcia,29,el Coll,70-74,3,6,-3
2017,6,Gràcia,30,la Salut,70-74,13,14,-1
2017,6,Gràcia,31,la Vila de Gràcia,70-74,21,25,-4
2017,6,Gràcia,32,el Camp d'en Grassot i Gràcia Nova,70-74,20,14,6
2017,7,Horta-Guinardó,33,el Baix Guinardó,70-74,9,13,-4
2017,7,Horta-Guinardó,34,Can Baró,70-74,5,10,-5
2017,7,Horta-Guinardó,35,el Guinardó,70-74,24,15,9
2017,7,Horta-Guinardó,36,la Font d'en Fargues,70-74,5,9,-4
2017,7,Horta-Guinardó,37,el Carmel,70-74,10,25,-15
2017,7,Horta-Guinardó,38,la Teixonera,70-74,8,5,3
2017,7,Horta-Guinardó,39,Sant Genís dels Agudells,70-74,10,6,4
2017,7,Horta-Guinardó,40,Montbau,70-74,7,4,3
2017,7,Horta-Guinardó,41,la Vall d'Hebron,70-74,1,4,-3
2017,7,Horta-Guinardó,42,la Clota,70-74,0,0,0
2017,7,Horta-Guinardó,43,Horta,70-74,18,21,-3
2017,8,Nou Barris,44,Vilapicina i la Torre Llobeta,70-74,18,6,12
2017,8,Nou Barris,45,Porta,70-74,11,13,-2
2017,8,Nou Barris,46,el Turó de la Peira,70-74,8,8,0
2017,8,Nou Barris,47,Can Peguera,70-74,1,3,-2
2017,8,Nou Barris,48,la Guineueta,70-74,6,7,-1
2017,8,Nou Barris,49,Canyelles,70-74,2,6,-4
2017,8,Nou Barris,50,les Roquetes,70-74,4,6,-2
2017,8,Nou Barris,51,Verdun,70-74,9,5,4
2017,8,Nou Barris,52,la Prosperitat,70-74,8,15,-7
2017,8,Nou Barris,53,la Trinitat Nova,70-74,4,4,0
2017,8,Nou Barris,54,Torre Baró,70-74,1,2,-1
2017,8,Nou Barris,55,Ciutat Meridiana,70-74,5,14,-9
2017,8,Nou Barris,56,Vallbona,70-74,0,0,0
2017,9,Sant Andreu,57,la Trinitat Vella,70-74,3,6,-3
2017,9,Sant Andreu,58,Baró de Viver,70-74,2,5,-3
2017,9,Sant Andreu,59,el Bon Pastor,70-74,8,5,3
2017,9,Sant Andreu,60,Sant Andreu,70-74,32,23,9
2017,9,Sant Andreu,61,la Sagrera,70-74,18,27,-9
2017,9,Sant Andreu,62,el Congrés i els Indians,70-74,8,7,1
2017,9,Sant Andreu,63,Navas,70-74,16,17,-1
2017,10,Sant Martí,64,el Camp de l'Arpa del Clot,70-74,16,23,-7
2017,10,Sant Martí,65,el Clot,70-74,12,12,0
2017,10,Sant Martí,66,el Parc i la Llacuna del Poblenou,70-74,8,8,0
2017,10,Sant Martí,67,la Vila Olímpica del Poblenou,70-74,8,3,5
2017,10,Sant Martí,68,el Poblenou,70-74,13,18,-5
2017,10,Sant Martí,69,Diagonal Mar i el Front Marítim del Poblenou,70-74,6,10,-4
2017,10,Sant Martí,70,el Besòs i el Maresme,70-74,18,14,4
2017,10,Sant Martí,71,Provençals del Poblenou,70-74,14,11,3
2017,10,Sant Martí,72,Sant Martí de Provençals,70-74,12,16,-4
2017,10,Sant Martí,73,la Verneda i la Pau,70-74,21,26,-5
2017,1,Ciutat Vella,1,el Raval,75-79,12,21,-9
2017,1,Ciutat Vella,2,el Barri Gòtic,75-79,5,5,0
2017,1,Ciutat Vella,3,la Barceloneta,75-79,5,6,-1
2017,1,Ciutat Vella,4,"Sant Pere, Santa Caterina i la Ribera",75-79,5,6,-1
2017,2,Eixample,5,el Fort Pienc,75-79,14,11,3
2017,2,Eixample,6,la Sagrada Família,75-79,21,16,5
2017,2,Eixample,7,la Dreta de l'Eixample,75-79,27,23,4
2017,2,Eixample,8,l'Antiga Esquerra de l'Eixample,75-79,15,19,-4
2017,2,Eixample,9,la Nova Esquerra de l'Eixample,75-79,33,31,2
2017,2,Eixample,10,Sant Antoni,75-79,11,25,-14
2017,3,Sants-Montjuïc,11,el Poble Sec,75-79,12,10,2
2017,3,Sants-Montjuïc,12,la Marina del Prat Vermell,75-79,0,0,0
2017,3,Sants-Montjuïc,13,la Marina de Port,75-79,15,14,1
2017,3,Sants-Montjuïc,14,la Font de la Guatlla,75-79,6,3,3
2017,3,Sants-Montjuïc,15,Hostafrancs,75-79,3,8,-5
2017,3,Sants-Montjuïc,16,la Bordeta,75-79,5,8,-3
2017,3,Sants-Montjuïc,17,Sants - Badal,75-79,9,13,-4
2017,3,Sants-Montjuïc,18,Sants,75-79,20,16,4
2017,4,Les Corts,19,les Corts,75-79,20,15,5
2017,4,Les Corts,20,la Maternitat i Sant Ramon,75-79,6,13,-7
2017,4,Les Corts,21,Pedralbes,75-79,10,3,7
2017,5,Sarrià-Sant Gervasi,22,"Vallvidrera, el Tibidabo i les Planes",75-79,2,1,1
2017,5,Sarrià-Sant Gervasi,23,Sarrià,75-79,9,18,-9
2017,5,Sarrià-Sant Gervasi,24,les Tres Torres,75-79,10,4,6
2017,5,Sarrià-Sant Gervasi,25,Sant Gervasi - la Bonanova,75-79,15,9,6
2017,5,Sarrià-Sant Gervasi,26,Sant Gervasi - Galvany,75-79,24,18,6
2017,5,Sarrià-Sant Gervasi,27,el Putxet i el Farró,75-79,19,11,8
2017,6,Gràcia,28,Vallcarca i els Penitents,75-79,5,8,-3
2017,6,Gràcia,29,el Coll,75-79,2,2,0
2017,6,Gràcia,30,la Salut,75-79,3,7,-4
2017,6,Gràcia,31,la Vila de Gràcia,75-79,18,20,-2
2017,6,Gràcia,32,el Camp d'en Grassot i Gràcia Nova,75-79,10,17,-7
2017,7,Horta-Guinardó,33,el Baix Guinardó,75-79,13,12,1
2017,7,Horta-Guinardó,34,Can Baró,75-79,6,7,-1
2017,7,Horta-Guinardó,35,el Guinardó,75-79,9,20,-11
2017,7,Horta-Guinardó,36,la Font d'en Fargues,75-79,2,8,-6
2017,7,Horta-Guinardó,37,el Carmel,75-79,6,24,-18
2017,7,Horta-Guinardó,38,la Teixonera,75-79,2,8,-6
2017,7,Horta-Guinardó,39,Sant Genís dels Agudells,75-79,3,3,0
2017,7,Horta-Guinardó,40,Montbau,75-79,3,4,-1
2017,7,Horta-Guinardó,41,la Vall d'Hebron,75-79,4,3,1
2017,7,Horta-Guinardó,42,la Clota,75-79,0,0,0
2017,7,Horta-Guinardó,43,Horta,75-79,6,17,-11
2017,8,Nou Barris,44,Vilapicina i la Torre Llobeta,75-79,6,13,-7
2017,8,Nou Barris,45,Porta,75-79,7,13,-6
2017,8,Nou Barris,46,el Turó de la Peira,75-79,0,2,-2
2017,8,Nou Barris,47,Can Peguera,75-79,0,0,0
2017,8,Nou Barris,48,la Guineueta,75-79,9,1,8
2017,8,Nou Barris,49,Canyelles,75-79,1,1,0
2017,8,Nou Barris,50,les Roquetes,75-79,6,11,-5
2017,8,Nou Barris,51,Verdun,75-79,3,6,-3
2017,8,Nou Barris,52,la Prosperitat,75-79,11,10,1
2017,8,Nou Barris,53,la Trinitat Nova,75-79,2,2,0
2017,8,Nou Barris,54,Torre Baró,75-79,0,1,-1
2017,8,Nou Barris,55,Ciutat Meridiana,75-79,7,4,3
2017,8,Nou Barris,56,Vallbona,75-79,1,0,1
2017,9,Sant Andreu,57,la Trinitat Vella,75-79,3,9,-6
2017,9,Sant Andreu,58,Baró de Viver,75-79,0,1,-1
2017,9,Sant Andreu,59,el Bon Pastor,75-79,5,5,0
2017,9,Sant Andreu,60,Sant Andreu,75-79,17,17,0
2017,9,Sant Andreu,61,la Sagrera,75-79,11,9,2
2017,9,Sant Andreu,62,el Congrés i els Indians,75-79,3,6,-3
2017,9,Sant Andreu,63,Navas,75-79,10,9,1
2017,10,Sant Martí,64,el Camp de l'Arpa del Clot,75-79,11,20,-9
2017,10,Sant Martí,65,el Clot,75-79,7,12,-5
2017,10,Sant Martí,66,el Parc i la Llacuna del Poblenou,75-79,5,3,2
2017,10,Sant Martí,67,la Vila Olímpica del Poblenou,75-79,5,3,2
2017,10,Sant Martí,68,el Poblenou,75-79,3,13,-10
2017,10,Sant Martí,69,Diagonal Mar i el Front Marítim del Poblenou,75-79,2,4,-2
2017,10,Sant Martí,70,el Besòs i el Maresme,75-79,7,13,-6
2017,10,Sant Martí,71,Provençals del Poblenou,75-79,6,6,0
2017,10,Sant Martí,72,Sant Martí de Provençals,75-79,11,10,1
2017,10,Sant Martí,73,la Verneda i la Pau,75-79,12,11,1
2017,1,Ciutat Vella,1,el Raval,80-84,9,15,-6
2017,1,Ciutat Vella,2,el Barri Gòtic,80-84,2,10,-8
2017,1,Ciutat Vella,3,la Barceloneta,80-84,6,8,-2
2017,1,Ciutat Vella,4,"Sant Pere, Santa Caterina i la Ribera",80-84,3,6,-3
2017,2,Eixample,5,el Fort Pienc,80-84,10,9,1
2017,2,Eixample,6,la Sagrada Família,80-84,21,25,-4
2017,2,Eixample,7,la Dreta de l'Eixample,80-84,16,26,-10
2017,2,Eixample,8,l'Antiga Esquerra de l'Eixample,80-84,12,22,-10
2017,2,Eixample,9,la Nova Esquerra de l'Eixample,80-84,24,16,8
2017,2,Eixample,10,Sant Antoni,80-84,8,18,-10
2017,3,Sants-Montjuïc,11,el Poble Sec,80-84,8,18,-10
2017,3,Sants-Montjuïc,12,la Marina del Prat Vermell,80-84,0,0,0
2017,3,Sants-Montjuïc,13,la Marina de Port,80-84,17,22,-5
2017,3,Sants-Montjuïc,14,la Font de la Guatlla,80-84,4,5,-1
2017,3,Sants-Montjuïc,15,Hostafrancs,80-84,7,9,-2
2017,3,Sants-Montjuïc,16,la Bordeta,80-84,6,7,-1
2017,3,Sants-Montjuïc,17,Sants - Badal,80-84,4,17,-13
2017,3,Sants-Montjuïc,18,Sants,80-84,21,15,6
2017,4,Les Corts,19,les Corts,80-84,23,20,3
2017,4,Les Corts,20,la Maternitat i Sant Ramon,80-84,7,6,1
2017,4,Les Corts,21,Pedralbes,80-84,10,5,5
2017,5,Sarrià-Sant Gervasi,22,"Vallvidrera, el Tibidabo i les Planes",80-84,0,4,-4
2017,5,Sarrià-Sant Gervasi,23,Sarrià,80-84,17,14,3
2017,5,Sarrià-Sant Gervasi,24,les Tres Torres,80-84,5,10,-5
2017,5,Sarrià-Sant Gervasi,25,Sant Gervasi - la Bonanova,80-84,16,12,4
2017,5,Sarrià-Sant Gervasi,26,Sant Gervasi - Galvany,80-84,17,9,8
2017,5,Sarrià-Sant Gervasi,27,el Putxet i el Farró,80-84,10,19,-9
2017,6,Gràcia,28,Vallcarca i els Penitents,80-84,6,6,0
2017,6,Gràcia,29,el Coll,80-84,2,3,-1
2017,6,Gràcia,30,la Salut,80-84,2,7,-5
2017,6,Gràcia,31,la Vila de Gràcia,80-84,19,27,-8
2017,6,Gràcia,32,el Camp d'en Grassot i Gràcia Nova,80-84,11,15,-4
2017,7,Horta-Guinardó,33,el Baix Guinardó,80-84,11,6,5
2017,7,Horta-Guinardó,34,Can Baró,80-84,5,9,-4
2017,7,Horta-Guinardó,35,el Guinardó,80-84,12,18,-6
2017,7,Horta-Guinardó,36,la Font d'en Fargues,80-84,4,3,1
2017,7,Horta-Guinardó,37,el Carmel,80-84,11,15,-4
2017,7,Horta-Guinardó,38,la Teixonera,80-84,3,7,-4
2017,7,Horta-Guinardó,39,Sant Genís dels Agudells,80-84,2,4,-2
2017,7,Horta-Guinardó,40,Montbau,80-84,6,4,2
2017,7,Horta-Guinardó,41,la Vall d'Hebron,80-84,4,4,0
2017,7,Horta-Guinardó,42,la Clota,80-84,0,0,0
2017,7,Horta-Guinardó,43,Horta,80-84,6,10,-4
2017,8,Nou Barris,44,Vilapicina i la Torre Llobeta,80-84,10,14,-4
2017,8,Nou Barris,45,Porta,80-84,8,17,-9
2017,8,Nou Barris,46,el Turó de la Peira,80-84,4,12,-8
2017,8,Nou Barris,47,Can Peguera,80-84,1,1,0
2017,8,Nou Barris,48,la Guineueta,80-84,7,5,2
2017,8,Nou Barris,49,Canyelles,80-84,4,6,-2
2017,8,Nou Barris,50,les Roquetes,80-84,1,8,-7
2017,8,Nou Barris,51,Verdun,80-84,2,9,-7
2017,8,Nou Barris,52,la Prosperitat,80-84,12,19,-7
2017,8,Nou Barris,53,la Trinitat Nova,80-84,1,7,-6
2017,8,Nou Barris,54,Torre Baró,80-84,0,1,-1
2017,8,Nou Barris,55,Ciutat Meridiana,80-84,1,9,-8
2017,8,Nou Barris,56,Vallbona,80-84,0,0,0
2017,9,Sant Andreu,57,la Trinitat Vella,80-84,2,9,-7
2017,9,Sant Andreu,58,Baró de Viver,80-84,3,0,3
2017,9,Sant Andreu,59,el Bon Pastor,80-84,3,4,-1
2017,9,Sant Andreu,60,Sant Andreu,80-84,15,15,0
2017,9,Sant Andreu,61,la Sagrera,80-84,7,9,-2
2017,9,Sant Andreu,62,el Congrés i els Indians,80-84,1,10,-9
2017,9,Sant Andreu,63,Navas,80-84,7,12,-5
2017,10,Sant Martí,64,el Camp de l'Arpa del Clot,80-84,13,17,-4
2017,10,Sant Martí,65,el Clot,80-84,6,13,-7
2017,10,Sant Martí,66,el Parc i la Llacuna del Poblenou,80-84,2,8,-6
2017,10,Sant Martí,67,la Vila Olímpica del Poblenou,80-84,2,1,1
2017,10,Sant Martí,68,el Poblenou,80-84,10,10,0
2017,10,Sant Martí,69,Diagonal Mar i el Front Marítim del Poblenou,80-84,6,4,2
2017,10,Sant Martí,70,el Besòs i el Maresme,80-84,6,17,-11
2017,10,Sant Martí,71,Provençals del Poblenou,80-84,8,9,-1
2017,10,Sant Martí,72,Sant Martí de Provençals,80-84,12,13,-1
2017,10,Sant Martí,73,la Verneda i la Pau,80-84,3,17,-14
2017,1,Ciutat Vella,1,el Raval,85-89,8,19,-11
2017,1,Ciutat Vella,2,el Barri Gòtic,85-89,1,8,-7
2017,1,Ciutat Vella,3,la Barceloneta,85-89,0,12,-12
2017,1,Ciutat Vella,4,"Sant Pere, Santa Caterina i la Ribera",85-89,6,9,-3
2017,2,Eixample,5,el Fort Pienc,85-89,5,15,-10
2017,2,Eixample,6,la Sagrada Família,85-89,19,24,-5
2017,2,Eixample,7,la Dreta de l'Eixample,85-89,14,24,-10
2017,2,Eixample,8,l'Antiga Esquerra de l'Eixample,85-89,12,22,-10
2017,2,Eixample,9,la Nova Esquerra de l'Eixample,85-89,15,32,-17
2017,2,Eixample,10,Sant Antoni,85-89,5,16,-11
2017,3,Sants-Montjuïc,11,el Poble Sec,85-89,6,11,-5
2017,3,Sants-Montjuïc,12,la Marina del Prat Vermell,85-89,1,1,0
2017,3,Sants-Montjuïc,13,la Marina de Port,85-89,8,10,-2
2017,3,Sants-Montjuïc,14,la Font de la Guatlla,85-89,3,4,-1
2017,3,Sants-Montjuïc,15,Hostafrancs,85-89,4,5,-1
2017,3,Sants-Montjuïc,16,la Bordeta,85-89,9,2,7
2017,3,Sants-Montjuïc,17,Sants - Badal,85-89,1,17,-16
2017,3,Sants-Montjuïc,18,Sants,85-89,8,23,-15
2017,4,Les Corts,19,les Corts,85-89,14,24,-10
2017,4,Les Corts,20,la Maternitat i Sant Ramon,85-89,9,8,1
2017,4,Les Corts,21,Pedralbes,85-89,3,7,-4
2017,5,Sarrià-Sant Gervasi,22,"Vallvidrera, el Tibidabo i les Planes",85-89,1,0,1
2017,5,Sarrià-Sant Gervasi,23,Sarrià,85-89,10,10,0
2017,5,Sarrià-Sant Gervasi,24,les Tres Torres,85-89,7,6,1
2017,5,Sarrià-Sant Gervasi,25,Sant Gervasi - la Bonanova,85-89,6,10,-4
2017,5,Sarrià-Sant Gervasi,26,Sant Gervasi - Galvany,85-89,21,10,11
2017,5,Sarrià-Sant Gervasi,27,el Putxet i el Farró,85-89,4,7,-3
2017,6,Gràcia,28,Vallcarca i els Penitents,85-89,2,6,-4
2017,6,Gràcia,29,el Coll,85-89,4,4,0
2017,6,Gràcia,30,la Salut,85-89,4,5,-1
2017,6,Gràcia,31,la Vila de Gràcia,85-89,26,24,2
2017,6,Gràcia,32,el Camp d'en Grassot i Gràcia Nova,85-89,11,12,-1
2017,7,Horta-Guinardó,33,el Baix Guinardó,85-89,13,13,0
2017,7,Horta-Guinardó,34,Can Baró,85-89,0,6,-6
2017,7,Horta-Guinardó,35,el Guinardó,85-89,5,21,-16
2017,7,Horta-Guinardó,36,la Font d'en Fargues,85-89,2,3,-1
2017,7,Horta-Guinardó,37,el Carmel,85-89,5,14,-9
2017,7,Horta-Guinardó,38,la Teixonera,85-89,2,7,-5
2017,7,Horta-Guinardó,39,Sant Genís dels Agudells,85-89,3,2,1
2017,7,Horta-Guinardó,40,Montbau,85-89,2,6,-4
2017,7,Horta-Guinardó,41,la Vall d'Hebron,85-89,1,1,0
2017,7,Horta-Guinardó,42,la Clota,85-89,0,0,0
2017,7,Horta-Guinardó,43,Horta,85-89,5,14,-9
2017,8,Nou Barris,44,Vilapicina i la Torre Llobeta,85-89,8,14,-6
2017,8,Nou Barris,45,Porta,85-89,5,16,-11
2017,8,Nou Barris,46,el Turó de la Peira,85-89,6,17,-11
2017,8,Nou Barris,47,Can Peguera,85-89,0,0,0
2017,8,Nou Barris,48,la Guineueta,85-89,4,9,-5
2017,8,Nou Barris,49,Canyelles,85-89,2,2,0
2017,8,Nou Barris,50,les Roquetes,85-89,0,8,-8
2017,8,Nou Barris,51,Verdun,85-89,2,6,-4
2017,8,Nou Barris,52,la Prosperitat,85-89,3,21,-18
2017,8,Nou Barris,53,la Trinitat Nova,85-89,3,9,-6
2017,8,Nou Barris,54,Torre Baró,85-89,0,0,0
2017,8,Nou Barris,55,Ciutat Meridiana,85-89,1,6,-5
2017,8,Nou Barris,56,Vallbona,85-89,1,1,0
2017,9,Sant Andreu,57,la Trinitat Vella,85-89,0,2,-2
2017,9,Sant Andreu,58,Baró de Viver,85-89,0,1,-1
2017,9,Sant Andreu,59,el Bon Pastor,85-89,0,5,-5
2017,9,Sant Andreu,60,Sant Andreu,85-89,18,29,-11
2017,9,Sant Andreu,61,la Sagrera,85-89,3,11,-8
2017,9,Sant Andreu,62,el Congrés i els Indians,85-89,1,7,-6
2017,9,Sant Andreu,63,Navas,85-89,4,8,-4
2017,10,Sant Martí,64,el Camp de l'Arpa del Clot,85-89,9,16,-7
2017,10,Sant Martí,65,el Clot,85-89,11,9,2
2017,10,Sant Martí,66,el Parc i la Llacuna del Poblenou,85-89,4,8,-4
2017,10,Sant Martí,67,la Vila Olímpica del Poblenou,85-89,1,0,1
2017,10,Sant Martí,68,el Poblenou,85-89,6,19,-13
2017,10,Sant Martí,69,Diagonal Mar i el Front Marítim del Poblenou,85-89,4,5,-1
2017,10,Sant Martí,70,el Besòs i el Maresme,85-89,3,14,-11
2017,10,Sant Martí,71,Provençals del Poblenou,85-89,1,8,-7
2017,10,Sant Martí,72,Sant Martí de Provençals,85-89,2,15,-13
2017,10,Sant Martí,73,la Verneda i la Pau,85-89,6,16,-10
2017,1,Ciutat Vella,1,el Raval,90-94,5,12,-7
2017,1,Ciutat Vella,2,el Barri Gòtic,90-94,3,4,-1
2017,1,Ciutat Vella,3,la Barceloneta,90-94,0,4,-4
2017,1,Ciutat Vella,4,"Sant Pere, Santa Caterina i la Ribera",90-94,2,7,-5
2017,2,Eixample,5,el Fort Pienc,90-94,6,9,-3
2017,2,Eixample,6,la Sagrada Família,90-94,7,12,-5
2017,2,Eixample,7,la Dreta de l'Eixample,90-94,9,10,-1
2017,2,Eixample,8,l'Antiga Esquerra de l'Eixample,90-94,12,6,6
2017,2,Eixample,9,la Nova Esquerra de l'Eixample,90-94,5,11,-6
2017,2,Eixample,10,Sant Antoni,90-94,5,6,-1
2017,3,Sants-Montjuïc,11,el Poble Sec,90-94,1,5,-4
2017,3,Sants-Montjuïc,12,la Marina del Prat Vermell,90-94,0,0,0
2017,3,Sants-Montjuïc,13,la Marina de Port,90-94,4,5,-1
2017,3,Sants-Montjuïc,14,la Font de la Guatlla,90-94,4,1,3
2017,3,Sants-Montjuïc,15,Hostafrancs,90-94,2,4,-2
2017,3,Sants-Montjuïc,16,la Bordeta,90-94,5,5,0
2017,3,Sants-Montjuïc,17,Sants - Badal,90-94,2,8,-6
2017,3,Sants-Montjuïc,18,Sants,90-94,5,16,-11
2017,4,Les Corts,19,les Corts,90-94,8,18,-10
2017,4,Les Corts,20,la Maternitat i Sant Ramon,90-94,3,15,-12
2017,4,Les Corts,21,Pedralbes,90-94,4,3,1
2017,5,Sarrià-Sant Gervasi,22,"Vallvidrera, el Tibidabo i les Planes",90-94,1,1,0
2017,5,Sarrià-Sant Gervasi,23,Sarrià,90-94,7,8,-1
2017,5,Sarrià-Sant Gervasi,24,les Tres Torres,90-94,2,1,1
2017,5,Sarrià-Sant Gervasi,25,Sant Gervasi - la Bonanova,90-94,9,9,0
2017,5,Sarrià-Sant Gervasi,26,Sant Gervasi - Galvany,90-94,6,10,-4
2017,5,Sarrià-Sant Gervasi,27,el Putxet i el Farró,90-94,4,6,-2
2017,6,Gràcia,28,Vallcarca i els Penitents,90-94,2,6,-4
2017,6,Gràcia,29,el Coll,90-94,3,2,1
2017,6,Gràcia,30,la Salut,90-94,1,3,-2
2017,6,Gràcia,31,la Vila de Gràcia,90-94,7,27,-20
2017,6,Gràcia,32,el Camp d'en Grassot i Gràcia Nova,90-94,6,8,-2
2017,7,Horta-Guinardó,33,el Baix Guinardó,90-94,9,8,1
2017,7,Horta-Guinardó,34,Can Baró,90-94,1,1,0
2017,7,Horta-Guinardó,35,el Guinardó,90-94,2,5,-3
2017,7,Horta-Guinardó,36,la Font d'en Fargues,90-94,0,0,0
2017,7,Horta-Guinardó,37,el Carmel,90-94,1,2,-1
2017,7,Horta-Guinardó,38,la Teixonera,90-94,0,2,-2
2017,7,Horta-Guinardó,39,Sant Genís dels Agudells,90-94,0,0,0
2017,7,Horta-Guinardó,40,Montbau,90-94,3,1,2
2017,7,Horta-Guinardó,41,la Vall d'Hebron,90-94,2,2,0
2017,7,Horta-Guinardó,42,la Clota,90-94,0,0,0
2017,7,Horta-Guinardó,43,Horta,90-94,9,9,0
2017,8,Nou Barris,44,Vilapicina i la Torre Llobeta,90-94,3,9,-6
2017,8,Nou Barris,45,Porta,90-94,3,5,-2
2017,8,Nou Barris,46,el Turó de la Peira,90-94,3,7,-4
2017,8,Nou Barris,47,Can Peguera,90-94,0,0,0
2017,8,Nou Barris,48,la Guineueta,90-94,0,4,-4
2017,8,Nou Barris,49,Canyelles,90-94,0,0,0
2017,8,Nou Barris,50,les Roquetes,90-94,0,1,-1
2017,8,Nou Barris,51,Verdun,90-94,1,4,-3
2017,8,Nou Barris,52,la Prosperitat,90-94,4,9,-5
2017,8,Nou Barris,53,la Trinitat Nova,90-94,0,4,-4
2017,8,Nou Barris,54,Torre Baró,90-94,0,0,0
2017,8,Nou Barris,55,Ciutat Meridiana,90-94,0,1,-1
2017,8,Nou Barris,56,Vallbona,90-94,0,0,0
2017,9,Sant Andreu,57,la Trinitat Vella,90-94,2,1,1
2017,9,Sant Andreu,58,Baró de Viver,90-94,0,1,-1
2017,9,Sant Andreu,59,el Bon Pastor,90-94,1,5,-4
2017,9,Sant Andreu,60,Sant Andreu,90-94,8,14,-6
2017,9,Sant Andreu,61,la Sagrera,90-94,2,15,-13
2017,9,Sant Andreu,62,el Congrés i els Indians,90-94,0,4,-4
2017,9,Sant Andreu,63,Navas,90-94,3,4,-1
2017,10,Sant Martí,64,el Camp de l'Arpa del Clot,90-94,4,13,-9
2017,10,Sant Martí,65,el Clot,90-94,2,7,-5
2017,10,Sant Martí,66,el Parc i la Llacuna del Poblenou,90-94,0,2,-2
2017,10,Sant Martí,67,la Vila Olímpica del Poblenou,90-94,1,2,-1
2017,10,Sant Martí,68,el Poblenou,90-94,4,8,-4
2017,10,Sant Martí,69,Diagonal Mar i el Front Marítim del Poblenou,90-94,3,3,0
2017,10,Sant Martí,70,el Besòs i el Maresme,90-94,2,6,-4
2017,10,Sant Martí,71,Provençals del Poblenou,90-94,4,8,-4
2017,10,Sant Martí,72,Sant Martí de Provençals,90-94,1,10,-9
2017,10,Sant Martí,73,la Verneda i la Pau,90-94,1,5,-4
2017,1,Ciutat Vella,1,el Raval,95-99,0,2,-2
2017,1,Ciutat Vella,2,el Barri Gòtic,95-99,0,1,-1
2017,1,Ciutat Vella,3,la Barceloneta,95-99,1,2,-1
2017,1,Ciutat Vella,4,"Sant Pere, Santa Caterina i la Ribera",95-99,0,3,-3
2017,2,Eixample,5,el Fort Pienc,95-99,2,2,0
2017,2,Eixample,6,la Sagrada Família,95-99,2,7,-5
2017,2,Eixample,7,la Dreta de l'Eixample,95-99,1,3,-2
2017,2,Eixample,8,l'Antiga Esquerra de l'Eixample,95-99,1,4,-3
2017,2,Eixample,9,la Nova Esquerra de l'Eixample,95-99,4,5,-1
2017,2,Eixample,10,Sant Antoni,95-99,0,4,-4
2017,3,Sants-Montjuïc,11,el Poble Sec,95-99,0,5,-5
2017,3,Sants-Montjuïc,12,la Marina del Prat Vermell,95-99,0,0,0
2017,3,Sants-Montjuïc,13,la Marina de Port,95-99,1,0,1
2017,3,Sants-Montjuïc,14,la Font de la Guatlla,95-99,1,1,0
2017,3,Sants-Montjuïc,15,Hostafrancs,95-99,0,3,-3
2017,3,Sants-Montjuïc,16,la Bordeta,95-99,1,1,0
2017,3,Sants-Montjuïc,17,Sants - Badal,95-99,1,4,-3
2017,3,Sants-Montjuïc,18,Sants,95-99,1,1,0
2017,4,Les Corts,19,les Corts,95-99,3,6,-3
2017,4,Les Corts,20,la Maternitat i Sant Ramon,95-99,3,2,1
2017,4,Les Corts,21,Pedralbes,95-99,0,0,0
2017,5,Sarrià-Sant Gervasi,22,"Vallvidrera, el Tibidabo i les Planes",95-99,0,1,-1
2017,5,Sarrià-Sant Gervasi,23,Sarrià,95-99,2,1,1
2017,5,Sarrià-Sant Gervasi,24,les Tres Torres,95-99,1,1,0
2017,5,Sarrià-Sant Gervasi,25,Sant Gervasi - la Bonanova,95-99,1,1,0
2017,5,Sarrià-Sant Gervasi,26,Sant Gervasi - Galvany,95-99,1,7,-6
2017,5,Sarrià-Sant Gervasi,27,el Putxet i el Farró,95-99,1,4,-3
2017,6,Gràcia,28,Vallcarca i els Penitents,95-99,1,0,1
2017,6,Gràcia,29,el Coll,95-99,0,1,-1
2017,6,Gràcia,30,la Salut,95-99,0,1,-1
2017,6,Gràcia,31,la Vila de Gràcia,95-99,1,4,-3
2017,6,Gràcia,32,el Camp d'en Grassot i Gràcia Nova,95-99,3,6,-3
2017,7,Horta-Guinardó,33,el Baix Guinardó,95-99,4,0,4
2017,7,Horta-Guinardó,34,Can Baró,95-99,0,0,0
2017,7,Horta-Guinardó,35,el Guinardó,95-99,3,4,-1
2017,7,Horta-Guinardó,36,la Font d'en Fargues,95-99,1,1,0
2017,7,Horta-Guinardó,37,el Carmel,95-99,1,4,-3
2017,7,Horta-Guinardó,38,la Teixonera,95-99,1,0,1
2017,7,Horta-Guinardó,39,Sant Genís dels Agudells,95-99,0,1,-1
2017,7,Horta-Guinardó,40,Montbau,95-99,0,0,0
2017,7,Horta-Guinardó,41,la Vall d'Hebron,95-99,0,0,0
2017,7,Horta-Guinardó,42,la Clota,95-99,0,0,0
2017,7,Horta-Guinardó,43,Horta,95-99,0,4,-4
2017,8,Nou Barris,44,Vilapicina i la Torre Llobeta,95-99,0,2,-2
2017,8,Nou Barris,45,Porta,95-99,2,1,1
2017,8,Nou Barris,46,el Turó de la Peira,95-99,0,0,0
2017,8,Nou Barris,47,Can Peguera,95-99,0,0,0
2017,8,Nou Barris,48,la Guineueta,95-99,1,2,-1
2017,8,Nou Barris,49,Canyelles,95-99,0,0,0
2017,8,Nou Barris,50,les Roquetes,95-99,0,1,-1
2017,8,Nou Barris,51,Verdun,95-99,0,2,-2
2017,8,Nou Barris,52,la Prosperitat,95-99,1,1,0
2017,8,Nou Barris,53,la Trinitat Nova,95-99,0,0,0
2017,8,Nou Barris,54,Torre Baró,95-99,0,0,0
2017,8,Nou Barris,55,Ciutat Meridiana,95-99,0,0,0
2017,8,Nou Barris,56,Vallbona,95-99,0,0,0
2017,9,Sant Andreu,57,la Trinitat Vella,95-99,0,1,-1
2017,9,Sant Andreu,58,Baró de Viver,95-99,0,0,0
2017,9,Sant Andreu,59,el Bon Pastor,95-99,0,0,0
2017,9,Sant Andreu,60,Sant Andreu,95-99,1,5,-4
2017,9,Sant Andreu,61,la Sagrera,95-99,1,1,0
2017,9,Sant Andreu,62,el Congrés i els Indians,95-99,1,0,1
2017,9,Sant Andreu,63,Navas,95-99,2,3,-1
2017,10,Sant Martí,64,el Camp de l'Arpa del Clot,95-99,0,4,-4
2017,10,Sant Martí,65,el Clot,95-99,0,1,-1
2017,10,Sant Martí,66,el Parc i la Llacuna del Poblenou,95-99,0,0,0
2017,10,Sant Martí,67,la Vila Olímpica del Poblenou,95-99,0,0,0
2017,10,Sant Martí,68,el Poblenou,95-99,2,2,0
2017,10,Sant Martí,69,Diagonal Mar i el Front Marítim del Poblenou,95-99,0,0,0
2017,10,Sant Martí,70,el Besòs i el Maresme,95-99,1,2,-1
2017,10,Sant Martí,71,Provençals del Poblenou,95-99,0,2,-2
2017,10,Sant Martí,72,Sant Martí de Provençals,95-99,0,2,-2
2017,10,Sant Martí,73,la Verneda i la Pau,95-99,0,2,-2
2017,1,Ciutat Vella,1,el Raval,>=100,0,0,0
2017,1,Ciutat Vella,2,el Barri Gòtic,>=100,0,0,0
2017,1,Ciutat Vella,3,la Barceloneta,>=100,0,0,0
2017,1,Ciutat Vella,4,"Sant Pere, Santa Caterina i la Ribera",>=100,0,0,0
2017,2,Eixample,5,el Fort Pienc,>=100,0,0,0
2017,2,Eixample,6,la Sagrada Família,>=100,0,1,-1
2017,2,Eixample,7,la Dreta de l'Eixample,>=100,0,0,0
2017,2,Eixample,8,l'Antiga Esquerra de l'Eixample,>=100,0,1,-1
2017,2,Eixample,9,la Nova Esquerra de l'Eixample,>=100,1,0,1
2017,2,Eixample,10,Sant Antoni,>=100,0,0,0
2017,3,Sants-Montjuïc,11,el Poble Sec,>=100,0,0,0
2017,3,Sants-Montjuïc,12,la Marina del Prat Vermell,>=100,0,0,0
2017,3,Sants-Montjuïc,13,la Marina de Port,>=100,0,0,0
2017,3,Sants-Montjuïc,14,la Font de la Guatlla,>=100,2,0,2
2017,3,Sants-Montjuïc,15,Hostafrancs,>=100,0,0,0
2017,3,Sants-Montjuïc,16,la Bordeta,>=100,0,0,0
2017,3,Sants-Montjuïc,17,Sants - Badal,>=100,0,0,0
2017,3,Sants-Montjuïc,18,Sants,>=100,0,0,0
2017,4,Les Corts,19,les Corts,>=100,0,1,-1
2017,4,Les Corts,20,la Maternitat i Sant Ramon,>=100,0,0,0
2017,4,Les Corts,21,Pedralbes,>=100,0,0,0
2017,5,Sarrià-Sant Gervasi,22,"Vallvidrera, el Tibidabo i les Planes",>=100,0,0,0
2017,5,Sarrià-Sant Gervasi,23,Sarrià,>=100,0,0,0
2017,5,Sarrià-Sant Gervasi,24,les Tres Torres,>=100,0,0,0
2017,5,Sarrià-Sant Gervasi,25,Sant Gervasi - la Bonanova,>=100,0,0,0
2017,5,Sarrià-Sant Gervasi,26,Sant Gervasi - Galvany,>=100,0,0,0
2017,5,Sarrià-Sant Gervasi,27,el Putxet i el Farró,>=100,0,1,-1
2017,6,Gràcia,28,Vallcarca i els Penitents,>=100,0,1,-1
2017,6,Gràcia,29,el Coll,>=100,0,0,0
2017,6,Gràcia,30,la Salut,>=100,0,0,0
2017,6,Gràcia,31,la Vila de Gràcia,>=100,0,0,0
2017,6,Gràcia,32,el Camp d'en Grassot i Gràcia Nova,>=100,1,1,0
2017,7,Horta-Guinardó,33,el Baix Guinardó,>=100,0,0,0
2017,7,Horta-Guinardó,34,Can Baró,>=100,0,0,0
2017,7,Horta-Guinardó,35,el Guinardó,>=100,0,0,0
2017,7,Horta-Guinardó,36,la Font d'en Fargues,>=100,0,0,0
2017,7,Horta-Guinardó,37,el Carmel,>=100,0,0,0
2017,7,Horta-Guinardó,38,la Teixonera,>=100,0,0,0
2017,7,Horta-Guinardó,39,Sant Genís dels Agudells,>=100,0,0,0
2017,7,Horta-Guinardó,40,Montbau,>=100,0,0,0
2017,7,Horta-Guinardó,41,la Vall d'Hebron,>=100,0,0,0
2017,7,Horta-Guinardó,42,la Clota,>=100,0,0,0
2017,7,Horta-Guinardó,43,Horta,>=100,0,0,0
2017,8,Nou Barris,44,Vilapicina i la Torre Llobeta,>=100,0,1,-1
2017,8,Nou Barris,45,Porta,>=100,0,0,0
2017,8,Nou Barris,46,el Turó de la Peira,>=100,0,0,0
2017,8,Nou Barris,47,Can Peguera,>=100,0,0,0
2017,8,Nou Barris,48,la Guineueta,>=100,0,0,0
2017,8,Nou Barris,49,Canyelles,>=100,0,0,0
2017,8,Nou Barris,50,les Roquetes,>=100,0,1,-1
2017,8,Nou Barris,51,Verdun,>=100,0,0,0
2017,8,Nou Barris,52,la Prosperitat,>=100,0,0,0
2017,8,Nou Barris,53,la Trinitat Nova,>=100,0,0,0
2017,8,Nou Barris,54,Torre Baró,>=100,0,0,0
2017,8,Nou Barris,55,Ciutat Meridiana,>=100,0,0,0
2017,8,Nou Barris,56,Vallbona,>=100,0,0,0
2017,9,Sant Andreu,57,la Trinitat Vella,>=100,0,0,0
2017,9,Sant Andreu,58,Baró de Viver,>=100,0,0,0
2017,9,Sant Andreu,59,el Bon Pastor,>=100,0,0,0
2017,9,Sant Andreu,60,Sant Andreu,>=100,0,0,0
2017,9,Sant Andreu,61,la Sagrera,>=100,0,0,0
2017,9,Sant Andreu,62,el Congrés i els Indians,>=100,0,0,0
2017,9,Sant Andreu,63,Navas,>=100,0,0,0
2017,10,Sant Martí,64,el Camp de l'Arpa del Clot,>=100,0,0,0
2017,10,Sant Martí,65,el Clot,>=100,0,1,-1
2017,10,Sant Martí,66,el Parc i la Llacuna del Poblenou,>=100,0,0,0
2017,10,Sant Martí,67,la Vila Olímpica del Poblenou,>=100,0,0,0
2017,10,Sant Martí,68,el Poblenou,>=100,0,0,0
2017,10,Sant Martí,69,Diagonal Mar i el Front Marítim del Poblenou,>=100,0,0,0
2017,10,Sant Martí,70,el Besòs i el Maresme,>=100,0,0,0
2017,10,Sant Martí,71,Provençals del Poblenou,>=100,0,0,0
2017,10,Sant Martí,72,Sant Martí de Provençals,>=100,0,0,0
2017,10,Sant Martí,73,la Verneda i la Pau,>=100,0,0,0
2016,1,Ciutat Vella,1,el Raval,0-4,210,117,93
2016,1,Ciutat Vella,2,el Barri Gòtic,0-4,57,37,20
2016,1,Ciutat Vella,3,la Barceloneta,0-4,40,24,16
2016,1,Ciutat Vella,4,"Sant Pere, Santa Caterina i la Ribera",0-4,55,45,10
2016,2,Eixample,5,el Fort Pienc,0-4,67,55,12
2016,2,Eixample,6,la Sagrada Família,0-4,102,80,22
2016,2,Eixample,7,la Dreta de l'Eixample,0-4,108,83,25
2016,2,Eixample,8,l'Antiga Esquerra de l'Eixample,0-4,108,58,50
2016,2,Eixample,9,la Nova Esquerra de l'Eixample,0-4,106,88,18
2016,2,Eixample,10,Sant Antoni,0-4,84,59,25
2016,3,Sants-Montjuïc,11,el Poble Sec,0-4,93,77,16
2016,3,Sants-Montjuïc,12,la Marina del Prat Vermell,0-4,1,6,-5
2016,3,Sants-Montjuïc,13,la Marina de Port,0-4,89,70,19
2016,3,Sants-Montjuïc,14,la Font de la Guatlla,0-4,22,23,-1
2016,3,Sants-Montjuïc,15,Hostafrancs,0-4,35,29,6
2016,3,Sants-Montjuïc,16,la Bordeta,0-4,42,49,-7
2016,3,Sants-Montjuïc,17,Sants - Badal,0-4,55,38,17
2016,3,Sants-Montjuïc,18,Sants,0-4,96,73,23
2016,4,Les Corts,19,les Corts,0-4,124,68,56
2016,4,Les Corts,20,la Maternitat i Sant Ramon,0-4,69,43,26
2016,4,Les Corts,21,Pedralbes,0-4,45,18,27
2016,5,Sarrià-Sant Gervasi,22,"Vallvidrera, el Tibidabo i les Planes",0-4,15,13,2
2016,5,Sarrià-Sant Gervasi,23,Sarrià,0-4,93,65,28
2016,5,Sarrià-Sant Gervasi,24,les Tres Torres,0-4,42,27,15
2016,5,Sarrià-Sant Gervasi,25,Sant Gervasi - la Bonanova,0-4,65,34,31
2016,5,Sarrià-Sant Gervasi,26,Sant Gervasi - Galvany,0-4,130,58,72
2016,5,Sarrià-Sant Gervasi,27,el Putxet i el Farró,0-4,63,66,-3
2016,6,Gràcia,28,Vallcarca i els Penitents,0-4,24,29,-5
2016,6,Gràcia,29,el Coll,0-4,14,9,5
2016,6,Gràcia,30,la Salut,0-4,21,14,7
2016,6,Gràcia,31,la Vila de Gràcia,0-4,90,93,-3
2016,6,Gràcia,32,el Camp d'en Grassot i Gràcia Nova,0-4,52,47,5
2016,7,Horta-Guinardó,33,el Baix Guinardó,0-4,43,37,6
2016,7,Horta-Guinardó,34,Can Baró,0-4,16,16,0
2016,7,Horta-Guinardó,35,el Guinardó,0-4,77,56,21
2016,7,Horta-Guinardó,36,la Font d'en Fargues,0-4,11,16,-5
2016,7,Horta-Guinardó,37,el Carmel,0-4,52,45,7
2016,7,Horta-Guinardó,38,la Teixonera,0-4,29,21,8
2016,7,Horta-Guinardó,39,Sant Genís dels Agudells,0-4,23,5,18
2016,7,Horta-Guinardó,40,Montbau,0-4,9,6,3
2016,7,Horta-Guinardó,41,la Vall d'Hebron,0-4,14,9,5
2016,7,Horta-Guinardó,42,la Clota,0-4,1,0,1
2016,7,Horta-Guinardó,43,Horta,0-4,43,29,14
2016,8,Nou Barris,44,Vilapicina i la Torre Llobeta,0-4,43,23,20
2016,8,Nou Barris,45,Porta,0-4,70,28,42
2016,8,Nou Barris,46,el Turó de la Peira,0-4,47,20,27
2016,8,Nou Barris,47,Can Peguera,0-4,4,5,-1
2016,8,Nou Barris,48,la Guineueta,0-4,28,16,12
2016,8,Nou Barris,49,Canyelles,0-4,11,7,4
2016,8,Nou Barris,50,les Roquetes,0-4,44,34,10
2016,8,Nou Barris,51,Verdun,0-4,25,29,-4
2016,8,Nou Barris,52,la Prosperitat,0-4,56,40,16
2016,8,Nou Barris,53,la Trinitat Nova,0-4,18,11,7
2016,8,Nou Barris,54,Torre Baró,0-4,7,5,2
2016,8,Nou Barris,55,Ciutat Meridiana,0-4,46,22,24
2016,8,Nou Barris,56,Vallbona,0-4,7,8,-1
2016,9,Sant Andreu,57,la Trinitat Vella,0-4,34,34,0
2016,9,Sant Andreu,58,Baró de Viver,0-4,5,6,-1
2016,9,Sant Andreu,59,el Bon Pastor,0-4,39,24,15
2016,9,Sant Andreu,60,Sant Andreu,0-4,109,77,32
2016,9,Sant Andreu,61,la Sagrera,0-4,71,42,29
2016,9,Sant Andreu,62,el Congrés i els Indians,0-4,14,19,-5
2016,9,Sant Andreu,63,Navas,0-4,48,41,7
2016,10,Sant Martí,64,el Camp de l'Arpa del Clot,0-4,54,87,-33
2016,10,Sant Martí,65,el Clot,0-4,46,31,15
2016,10,Sant Martí,66,el Parc i la Llacuna del Poblenou,0-4,32,25,7
2016,10,Sant Martí,67,la Vila Olímpica del Poblenou,0-4,27,20,7
2016,10,Sant Martí,68,el Poblenou,0-4,88,57,31
2016,10,Sant Martí,69,Diagonal Mar i el Front Marítim del Poblenou,0-4,59,41,18
2016,10,Sant Martí,70,el Besòs i el Maresme,0-4,97,80,17
2016,10,Sant Martí,71,Provençals del Poblenou,0-4,42,39,3
2016,10,Sant Martí,72,Sant Martí de Provençals,0-4,25,32,-7
2016,10,Sant Martí,73,la Verneda i la Pau,0-4,44,46,-2
2016,1,Ciutat Vella,1,el Raval,5-9,139,100,39
2016,1,Ciutat Vella,2,el Barri Gòtic,5-9,44,27,17
2016,1,Ciutat Vella,3,la Barceloneta,5-9,19,19,0
2016,1,Ciutat Vella,4,"Sant Pere, Santa Caterina i la Ribera",5-9,40,26,14
2016,2,Eixample,5,el Fort Pienc,5-9,44,27,17
2016,2,Eixample,6,la Sagrada Família,5-9,80,47,33
2016,2,Eixample,7,la Dreta de l'Eixample,5-9,63,39,24
2016,2,Eixample,8,l'Antiga Esquerra de l'Eixample,5-9,50,34,16
2016,2,Eixample,9,la Nova Esquerra de l'Eixample,5-9,69,51,18
2016,2,Eixample,10,Sant Antoni,5-9,40,26,14
2016,3,Sants-Montjuïc,11,el Poble Sec,5-9,78,40,38
2016,3,Sants-Montjuïc,12,la Marina del Prat Vermell,5-9,1,0,1
2016,3,Sants-Montjuïc,13,la Marina de Port,5-9,50,39,11
2016,3,Sants-Montjuïc,14,la Font de la Guatlla,5-9,14,12,2
2016,3,Sants-Montjuïc,15,Hostafrancs,5-9,28,21,7
2016,3,Sants-Montjuïc,16,la Bordeta,5-9,35,25,10
2016,3,Sants-Montjuïc,17,Sants - Badal,5-9,49,40,9
2016,3,Sants-Montjuïc,18,Sants,5-9,58,48,10
2016,4,Les Corts,19,les Corts,5-9,62,46,16
2016,4,Les Corts,20,la Maternitat i Sant Ramon,5-9,40,25,15
2016,4,Les Corts,21,Pedralbes,5-9,58,13,45
2016,5,Sarrià-Sant Gervasi,22,"Vallvidrera, el Tibidabo i les Planes",5-9,4,4,0
2016,5,Sarrià-Sant Gervasi,23,Sarrià,5-9,74,35,39
2016,5,Sarrià-Sant Gervasi,24,les Tres Torres,5-9,35,31,4
2016,5,Sarrià-Sant Gervasi,25,Sant Gervasi - la Bonanova,5-9,49,27,22
2016,5,Sarrià-Sant Gervasi,26,Sant Gervasi - Galvany,5-9,97,42,55
2016,5,Sarrià-Sant Gervasi,27,el Putxet i el Farró,5-9,55,34,21
2016,6,Gràcia,28,Vallcarca i els Penitents,5-9,27,12,15
2016,6,Gràcia,29,el Coll,5-9,15,8,7
2016,6,Gràcia,30,la Salut,5-9,13,10,3
2016,6,Gràcia,31,la Vila de Gràcia,5-9,52,54,-2
2016,6,Gràcia,32,el Camp d'en Grassot i Gràcia Nova,5-9,34,28,6
2016,7,Horta-Guinardó,33,el Baix Guinardó,5-9,27,34,-7
2016,7,Horta-Guinardó,34,Can Baró,5-9,9,6,3
2016,7,Horta-Guinardó,35,el Guinardó,5-9,60,24,36
2016,7,Horta-Guinardó,36,la Font d'en Fargues,5-9,8,13,-5
2016,7,Horta-Guinardó,37,el Carmel,5-9,35,33,2
2016,7,Horta-Guinardó,38,la Teixonera,5-9,25,7,18
2016,7,Horta-Guinardó,39,Sant Genís dels Agudells,5-9,12,8,4
2016,7,Horta-Guinardó,40,Montbau,5-9,12,5,7
2016,7,Horta-Guinardó,41,la Vall d'Hebron,5-9,7,4,3
2016,7,Horta-Guinardó,42,la Clota,5-9,1,0,1
2016,7,Horta-Guinardó,43,Horta,5-9,40,20,20
2016,8,Nou Barris,44,Vilapicina i la Torre Llobeta,5-9,46,25,21
2016,8,Nou Barris,45,Porta,5-9,47,27,20
2016,8,Nou Barris,46,el Turó de la Peira,5-9,28,14,14
2016,8,Nou Barris,47,Can Peguera,5-9,3,4,-1
2016,8,Nou Barris,48,la Guineueta,5-9,24,8,16
2016,8,Nou Barris,49,Canyelles,5-9,7,4,3
2016,8,Nou Barris,50,les Roquetes,5-9,40,29,11
2016,8,Nou Barris,51,Verdun,5-9,24,22,2
2016,8,Nou Barris,52,la Prosperitat,5-9,43,13,30
2016,8,Nou Barris,53,la Trinitat Nova,5-9,11,11,0
2016,8,Nou Barris,54,Torre Baró,5-9,6,5,1
2016,8,Nou Barris,55,Ciutat Meridiana,5-9,26,15,11
2016,8,Nou Barris,56,Vallbona,5-9,5,3,2
2016,9,Sant Andreu,57,la Trinitat Vella,5-9,29,26,3
2016,9,Sant Andreu,58,Baró de Viver,5-9,3,6,-3
2016,9,Sant Andreu,59,el Bon Pastor,5-9,27,19,8
2016,9,Sant Andreu,60,Sant Andreu,5-9,52,56,-4
2016,9,Sant Andreu,61,la Sagrera,5-9,38,21,17
2016,9,Sant Andreu,62,el Congrés i els Indians,5-9,15,16,-1
2016,9,Sant Andreu,63,Navas,5-9,29,34,-5
2016,10,Sant Martí,64,el Camp de l'Arpa del Clot,5-9,57,40,17
2016,10,Sant Martí,65,el Clot,5-9,27,19,8
2016,10,Sant Martí,66,el Parc i la Llacuna del Poblenou,5-9,19,13,6
2016,10,Sant Martí,67,la Vila Olímpica del Poblenou,5-9,14,10,4
2016,10,Sant Martí,68,el Poblenou,5-9,55,46,9
2016,10,Sant Martí,69,Diagonal Mar i el Front Marítim del Poblenou,5-9,36,21,15
2016,10,Sant Martí,70,el Besòs i el Maresme,5-9,89,80,9
2016,10,Sant Martí,71,Provençals del Poblenou,5-9,25,35,-10
2016,10,Sant Martí,72,Sant Martí de Provençals,5-9,36,25,11
2016,10,Sant Martí,73,la Verneda i la Pau,5-9,37,36,1
2016,1,Ciutat Vella,1,el Raval,10-14,121,47,74
2016,1,Ciutat Vella,2,el Barri Gòtic,10-14,36,20,16
2016,1,Ciutat Vella,3,la Barceloneta,10-14,22,7,15
2016,1,Ciutat Vella,4,"Sant Pere, Santa Caterina i la Ribera",10-14,39,14,25
2016,2,Eixample,5,el Fort Pienc,10-14,31,23,8
2016,2,Eixample,6,la Sagrada Família,10-14,65,33,32
2016,2,Eixample,7,la Dreta de l'Eixample,10-14,78,44,34
2016,2,Eixample,8,l'Antiga Esquerra de l'Eixample,10-14,44,23,21
2016,2,Eixample,9,la Nova Esquerra de l'Eixample,10-14,88,48,40
2016,2,Eixample,10,Sant Antoni,10-14,46,27,19
2016,3,Sants-Montjuïc,11,el Poble Sec,10-14,78,48,30
2016,3,Sants-Montjuïc,12,la Marina del Prat Vermell,10-14,3,4,-1
2016,3,Sants-Montjuïc,13,la Marina de Port,10-14,46,44,2
2016,3,Sants-Montjuïc,14,la Font de la Guatlla,10-14,10,10,0
2016,3,Sants-Montjuïc,15,Hostafrancs,10-14,31,10,21
2016,3,Sants-Montjuïc,16,la Bordeta,10-14,30,21,9
2016,3,Sants-Montjuïc,17,Sants - Badal,10-14,52,31,21
2016,3,Sants-Montjuïc,18,Sants,10-14,69,35,34
2016,4,Les Corts,19,les Corts,10-14,63,38,25
2016,4,Les Corts,20,la Maternitat i Sant Ramon,10-14,40,35,5
2016,4,Les Corts,21,Pedralbes,10-14,58,22,36
2016,5,Sarrià-Sant Gervasi,22,"Vallvidrera, el Tibidabo i les Planes",10-14,4,7,-3
2016,5,Sarrià-Sant Gervasi,23,Sarrià,10-14,64,28,36
2016,5,Sarrià-Sant Gervasi,24,les Tres Torres,10-14,32,23,9
2016,5,Sarrià-Sant Gervasi,25,Sant Gervasi - la Bonanova,10-14,92,26,66
2016,5,Sarrià-Sant Gervasi,26,Sant Gervasi - Galvany,10-14,138,51,87
2016,5,Sarrià-Sant Gervasi,27,el Putxet i el Farró,10-14,38,24,14
2016,6,Gràcia,28,Vallcarca i els Penitents,10-14,24,10,14
2016,6,Gràcia,29,el Coll,10-14,16,7,9
2016,6,Gràcia,30,la Salut,10-14,13,12,1
2016,6,Gràcia,31,la Vila de Gràcia,10-14,48,24,24
2016,6,Gràcia,32,el Camp d'en Grassot i Gràcia Nova,10-14,37,16,21
2016,7,Horta-Guinardó,33,el Baix Guinardó,10-14,16,12,4
2016,7,Horta-Guinardó,34,Can Baró,10-14,9,5,4
2016,7,Horta-Guinardó,35,el Guinardó,10-14,48,29,19
2016,7,Horta-Guinardó,36,la Font d'en Fargues,10-14,4,7,-3
2016,7,Horta-Guinardó,37,el Carmel,10-14,50,20,30
2016,7,Horta-Guinardó,38,la Teixonera,10-14,21,9,12
2016,7,Horta-Guinardó,39,Sant Genís dels Agudells,10-14,23,9,14
2016,7,Horta-Guinardó,40,Montbau,10-14,5,2,3
2016,7,Horta-Guinardó,41,la Vall d'Hebron,10-14,6,1,5
2016,7,Horta-Guinardó,42,la Clota,10-14,0,0,0
2016,7,Horta-Guinardó,43,Horta,10-14,38,2,36
2016,8,Nou Barris,44,Vilapicina i la Torre Llobeta,10-14,49,25,24
2016,8,Nou Barris,45,Porta,10-14,61,17,44
2016,8,Nou Barris,46,el Turó de la Peira,10-14,33,20,13
2016,8,Nou Barris,47,Can Peguera,10-14,5,4,1
2016,8,Nou Barris,48,la Guineueta,10-14,19,13,6
2016,8,Nou Barris,49,Canyelles,10-14,5,7,-2
2016,8,Nou Barris,50,les Roquetes,10-14,56,17,39
2016,8,Nou Barris,51,Verdun,10-14,30,14,16
2016,8,Nou Barris,52,la Prosperitat,10-14,43,24,19
2016,8,Nou Barris,53,la Trinitat Nova,10-14,11,11,0
2016,8,Nou Barris,54,Torre Baró,10-14,6,1,5
2016,8,Nou Barris,55,Ciutat Meridiana,10-14,28,18,10
2016,8,Nou Barris,56,Vallbona,10-14,3,0,3
2016,9,Sant Andreu,57,la Trinitat Vella,10-14,26,20,6
2016,9,Sant Andreu,58,Baró de Viver,10-14,5,5,0
2016,9,Sant Andreu,59,el Bon Pastor,10-14,22,24,-2
2016,9,Sant Andreu,60,Sant Andreu,10-14,39,15,24
2016,9,Sant Andreu,61,la Sagrera,10-14,44,21,23
2016,9,Sant Andreu,62,el Congrés i els Indians,10-14,20,10,10
2016,9,Sant Andreu,63,Navas,10-14,43,24,19
2016,10,Sant Martí,64,el Camp de l'Arpa del Clot,10-14,43,30,13
2016,10,Sant Martí,65,el Clot,10-14,24,23,1
2016,10,Sant Martí,66,el Parc i la Llacuna del Poblenou,10-14,17,10,7
2016,10,Sant Martí,67,la Vila Olímpica del Poblenou,10-14,12,5,7
2016,10,Sant Martí,68,el Poblenou,10-14,42,32,10
2016,10,Sant Martí,69,Diagonal Mar i el Front Marítim del Poblenou,10-14,17,13,4
2016,10,Sant Martí,70,el Besòs i el Maresme,10-14,76,49,27
2016,10,Sant Martí,71,Provençals del Poblenou,10-14,25,15,10
2016,10,Sant Martí,72,Sant Martí de Provençals,10-14,29,32,-3
2016,10,Sant Martí,73,la Verneda i la Pau,10-14,44,25,19
2016,1,Ciutat Vella,1,el Raval,15-19,238,86,152
2016,1,Ciutat Vella,2,el Barri Gòtic,15-19,89,18,71
2016,1,Ciutat Vella,3,la Barceloneta,15-19,50,25,25
2016,1,Ciutat Vella,4,"Sant Pere, Santa Caterina i la Ribera",15-19,153,31,122
2016,2,Eixample,5,el Fort Pienc,15-19,71,20,51
2016,2,Eixample,6,la Sagrada Família,15-19,133,43,90
2016,2,Eixample,7,la Dreta de l'Eixample,15-19,102,30,72
2016,2,Eixample,8,l'Antiga Esquerra de l'Eixample,15-19,94,30,64
2016,2,Eixample,9,la Nova Esquerra de l'Eixample,15-19,118,49,69
2016,2,Eixample,10,Sant Antoni,15-19,88,34,54
2016,3,Sants-Montjuïc,11,el Poble Sec,15-19,166,71,95
2016,3,Sants-Montjuïc,12,la Marina del Prat Vermell,15-19,3,4,-1
2016,3,Sants-Montjuïc,13,la Marina de Port,15-19,86,47,39
2016,3,Sants-Montjuïc,14,la Font de la Guatlla,15-19,19,10,9
2016,3,Sants-Montjuïc,15,Hostafrancs,15-19,41,15,26
2016,3,Sants-Montjuïc,16,la Bordeta,15-19,34,15,19
2016,3,Sants-Montjuïc,17,Sants - Badal,15-19,63,34,29
2016,3,Sants-Montjuïc,18,Sants,15-19,115,32,83
2016,4,Les Corts,19,les Corts,15-19,95,32,63
2016,4,Les Corts,20,la Maternitat i Sant Ramon,15-19,46,24,22
2016,4,Les Corts,21,Pedralbes,15-19,50,22,28
2016,5,Sarrià-Sant Gervasi,22,"Vallvidrera, el Tibidabo i les Planes",15-19,7,5,2
2016,5,Sarrià-Sant Gervasi,23,Sarrià,15-19,90,29,61
2016,5,Sarrià-Sant Gervasi,24,les Tres Torres,15-19,38,11,27
2016,5,Sarrià-Sant Gervasi,25,Sant Gervasi - la Bonanova,15-19,89,26,63
2016,5,Sarrià-Sant Gervasi,26,Sant Gervasi - Galvany,15-19,141,43,98
2016,5,Sarrià-Sant Gervasi,27,el Putxet i el Farró,15-19,42,21,21
2016,6,Gràcia,28,Vallcarca i els Penitents,15-19,40,15,25
2016,6,Gràcia,29,el Coll,15-19,20,12,8
2016,6,Gràcia,30,la Salut,15-19,60,24,36
2016,6,Gràcia,31,la Vila de Gràcia,15-19,89,26,63
2016,6,Gràcia,32,el Camp d'en Grassot i Gràcia Nova,15-19,41,15,26
2016,7,Horta-Guinardó,33,el Baix Guinardó,15-19,35,18,17
2016,7,Horta-Guinardó,34,Can Baró,15-19,21,3,18
2016,7,Horta-Guinardó,35,el Guinardó,15-19,70,37,33
2016,7,Horta-Guinardó,36,la Font d'en Fargues,15-19,7,4,3
2016,7,Horta-Guinardó,37,el Carmel,15-19,62,33,29
2016,7,Horta-Guinardó,38,la Teixonera,15-19,28,15,13
2016,7,Horta-Guinardó,39,Sant Genís dels Agudells,15-19,41,6,35
2016,7,Horta-Guinardó,40,Montbau,15-19,13,3,10
2016,7,Horta-Guinardó,41,la Vall d'Hebron,15-19,8,4,4
2016,7,Horta-Guinardó,42,la Clota,15-19,0,0,0
2016,7,Horta-Guinardó,43,Horta,15-19,63,12,51
2016,8,Nou Barris,44,Vilapicina i la Torre Llobeta,15-19,52,26,26
2016,8,Nou Barris,45,Porta,15-19,79,25,54
2016,8,Nou Barris,46,el Turó de la Peira,15-19,59,30,29
2016,8,Nou Barris,47,Can Peguera,15-19,9,2,7
2016,8,Nou Barris,48,la Guineueta,15-19,31,10,21
2016,8,Nou Barris,49,Canyelles,15-19,1,9,-8
2016,8,Nou Barris,50,les Roquetes,15-19,48,20,28
2016,8,Nou Barris,51,Verdun,15-19,32,15,17
2016,8,Nou Barris,52,la Prosperitat,15-19,67,23,44
2016,8,Nou Barris,53,la Trinitat Nova,15-19,21,7,14
2016,8,Nou Barris,54,Torre Baró,15-19,7,2,5
2016,8,Nou Barris,55,Ciutat Meridiana,15-19,67,26,41
2016,8,Nou Barris,56,Vallbona,15-19,2,4,-2
2016,9,Sant Andreu,57,la Trinitat Vella,15-19,33,17,16
2016,9,Sant Andreu,58,Baró de Viver,15-19,3,2,1
2016,9,Sant Andreu,59,el Bon Pastor,15-19,25,21,4
2016,9,Sant Andreu,60,Sant Andreu,15-19,79,29,50
2016,9,Sant Andreu,61,la Sagrera,15-19,61,17,44
2016,9,Sant Andreu,62,el Congrés i els Indians,15-19,28,10,18
2016,9,Sant Andreu,63,Navas,15-19,44,21,23
2016,10,Sant Martí,64,el Camp de l'Arpa del Clot,15-19,59,32,27
2016,10,Sant Martí,65,el Clot,15-19,44,22,22
2016,10,Sant Martí,66,el Parc i la Llacuna del Poblenou,15-19,51,13,38
2016,10,Sant Martí,67,la Vila Olímpica del Poblenou,15-19,19,7,12
2016,10,Sant Martí,68,el Poblenou,15-19,49,25,24
2016,10,Sant Martí,69,Diagonal Mar i el Front Marítim del Poblenou,15-19,22,13,9
2016,10,Sant Martí,70,el Besòs i el Maresme,15-19,90,48,42
2016,10,Sant Martí,71,Provençals del Poblenou,15-19,42,27,15
2016,10,Sant Martí,72,Sant Martí de Provençals,15-19,106,26,80
2016,10,Sant Martí,73,la Verneda i la Pau,15-19,56,23,33
2016,1,Ciutat Vella,1,el Raval,20-24,767,148,619
2016,1,Ciutat Vella,2,el Barri Gòtic,20-24,414,64,350
2016,1,Ciutat Vella,3,la Barceloneta,20-24,241,41,200
2016,1,Ciutat Vella,4,"Sant Pere, Santa Caterina i la Ribera",20-24,370,59,311
2016,2,Eixample,5,el Fort Pienc,20-24,300,45,255
2016,2,Eixample,6,la Sagrada Família,20-24,461,116,345
2016,2,Eixample,7,la Dreta de l'Eixample,20-24,449,83,366
2016,2,Eixample,8,l'Antiga Esquerra de l'Eixample,20-24,450,85,365
2016,2,Eixample,9,la Nova Esquerra de l'Eixample,20-24,500,108,392
2016,2,Eixample,10,Sant Antoni,20-24,311,68,243
2016,3,Sants-Montjuïc,11,el Poble Sec,20-24,341,105,236
2016,3,Sants-Montjuïc,12,la Marina del Prat Vermell,20-24,6,4,2
2016,3,Sants-Montjuïc,13,la Marina de Port,20-24,144,63,81
2016,3,Sants-Montjuïc,14,la Font de la Guatlla,20-24,97,33,64
2016,3,Sants-Montjuïc,15,Hostafrancs,20-24,132,40,92
2016,3,Sants-Montjuïc,16,la Bordeta,20-24,109,36,73
2016,3,Sants-Montjuïc,17,Sants - Badal,20-24,199,85,114
2016,3,Sants-Montjuïc,18,Sants,20-24,294,107,187
2016,4,Les Corts,19,les Corts,20-24,201,69,132
2016,4,Les Corts,20,la Maternitat i Sant Ramon,20-24,139,43,96
2016,4,Les Corts,21,Pedralbes,20-24,51,17,34
2016,5,Sarrià-Sant Gervasi,22,"Vallvidrera, el Tibidabo i les Planes",20-24,14,4,10
2016,5,Sarrià-Sant Gervasi,23,Sarrià,20-24,93,30,63
2016,5,Sarrià-Sant Gervasi,24,les Tres Torres,20-24,80,15,65
2016,5,Sarrià-Sant Gervasi,25,Sant Gervasi - la Bonanova,20-24,113,35,78
2016,5,Sarrià-Sant Gervasi,26,Sant Gervasi - Galvany,20-24,208,65,143
2016,5,Sarrià-Sant Gervasi,27,el Putxet i el Farró,20-24,149,36,113
2016,6,Gràcia,28,Vallcarca i els Penitents,20-24,69,27,42
2016,6,Gràcia,29,el Coll,20-24,45,25,20
2016,6,Gràcia,30,la Salut,20-24,69,18,51
2016,6,Gràcia,31,la Vila de Gràcia,20-24,405,78,327
2016,6,Gràcia,32,el Camp d'en Grassot i Gràcia Nova,20-24,195,48,147
2016,7,Horta-Guinardó,33,el Baix Guinardó,20-24,121,56,65
2016,7,Horta-Guinardó,34,Can Baró,20-24,44,15,29
2016,7,Horta-Guinardó,35,el Guinardó,20-24,194,46,148
2016,7,Horta-Guinardó,36,la Font d'en Fargues,20-24,14,10,4
2016,7,Horta-Guinardó,37,el Carmel,20-24,147,67,80
2016,7,Horta-Guinardó,38,la Teixonera,20-24,70,19,51
2016,7,Horta-Guinardó,39,Sant Genís dels Agudells,20-24,34,9,25
2016,7,Horta-Guinardó,40,Montbau,20-24,21,9,12
2016,7,Horta-Guinardó,41,la Vall d'Hebron,20-24,21,2,19
2016,7,Horta-Guinardó,42,la Clota,20-24,3,0,3
2016,7,Horta-Guinardó,43,Horta,20-24,83,48,35
2016,8,Nou Barris,44,Vilapicina i la Torre Llobeta,20-24,106,35,71
2016,8,Nou Barris,45,Porta,20-24,138,43,95
2016,8,Nou Barris,46,el Turó de la Peira,20-24,77,35,42
2016,8,Nou Barris,47,Can Peguera,20-24,3,1,2
2016,8,Nou Barris,48,la Guineueta,20-24,48,15,33
2016,8,Nou Barris,49,Canyelles,20-24,12,7,5
2016,8,Nou Barris,50,les Roquetes,20-24,107,48,59
2016,8,Nou Barris,51,Verdun,20-24,69,23,46
2016,8,Nou Barris,52,la Prosperitat,20-24,150,71,79
2016,8,Nou Barris,53,la Trinitat Nova,20-24,40,20,20
2016,8,Nou Barris,54,Torre Baró,20-24,16,9,7
2016,8,Nou Barris,55,Ciutat Meridiana,20-24,75,36,39
2016,8,Nou Barris,56,Vallbona,20-24,5,6,-1
2016,9,Sant Andreu,57,la Trinitat Vella,20-24,60,31,29
2016,9,Sant Andreu,58,Baró de Viver,20-24,12,9,3
2016,9,Sant Andreu,59,el Bon Pastor,20-24,51,36,15
2016,9,Sant Andreu,60,Sant Andreu,20-24,186,91,95
2016,9,Sant Andreu,61,la Sagrera,20-24,146,66,80
2016,9,Sant Andreu,62,el Congrés i els Indians,20-24,69,33,36
2016,9,Sant Andreu,63,Navas,20-24,98,29,69
2016,10,Sant Martí,64,el Camp de l'Arpa del Clot,20-24,269,73,196
2016,10,Sant Martí,65,el Clot,20-24,147,40,107
2016,10,Sant Martí,66,el Parc i la Llacuna del Poblenou,20-24,163,27,136
2016,10,Sant Martí,67,la Vila Olímpica del Poblenou,20-24,35,14,21
2016,10,Sant Martí,68,el Poblenou,20-24,151,31,120
2016,10,Sant Martí,69,Diagonal Mar i el Front Marítim del Poblenou,20-24,36,16,20
2016,10,Sant Martí,70,el Besòs i el Maresme,20-24,164,89,75
2016,10,Sant Martí,71,Provençals del Poblenou,20-24,70,37,33
2016,10,Sant Martí,72,Sant Martí de Provençals,20-24,134,63,71
2016,10,Sant Martí,73,la Verneda i la Pau,20-24,101,53,48
2016,1,Ciutat Vella,1,el Raval,25-29,1190,294,896
2016,1,Ciutat Vella,2,el Barri Gòtic,25-29,642,113,529
2016,1,Ciutat Vella,3,la Barceloneta,25-29,460,97,363
2016,1,Ciutat Vella,4,"Sant Pere, Santa Caterina i la Ribera",25-29,649,133,516
2016,2,Eixample,5,el Fort Pienc,25-29,506,140,366
2016,2,Eixample,6,la Sagrada Família,25-29,766,206,560
2016,2,Eixample,7,la Dreta de l'Eixample,25-29,664,156,508
2016,2,Eixample,8,l'Antiga Esquerra de l'Eixample,25-29,773,160,613
2016,2,Eixample,9,la Nova Esquerra de l'Eixample,25-29,910,220,690
2016,2,Eixample,10,Sant Antoni,25-29,538,155,383
2016,3,Sants-Montjuïc,11,el Poble Sec,25-29,572,208,364
2016,3,Sants-Montjuïc,12,la Marina del Prat Vermell,25-29,7,4,3
2016,3,Sants-Montjuïc,13,la Marina de Port,25-29,204,142,62
2016,3,Sants-Montjuïc,14,la Font de la Guatlla,25-29,125,63,62
2016,3,Sants-Montjuïc,15,Hostafrancs,25-29,231,80,151
2016,3,Sants-Montjuïc,16,la Bordeta,25-29,157,77,80
2016,3,Sants-Montjuïc,17,Sants - Badal,25-29,270,153,117
2016,3,Sants-Montjuïc,18,Sants,25-29,488,212,276
2016,4,Les Corts,19,les Corts,25-29,404,169,235
2016,4,Les Corts,20,la Maternitat i Sant Ramon,25-29,244,115,129
2016,4,Les Corts,21,Pedralbes,25-29,85,31,54
2016,5,Sarrià-Sant Gervasi,22,"Vallvidrera, el Tibidabo i les Planes",25-29,13,16,-3
2016,5,Sarrià-Sant Gervasi,23,Sarrià,25-29,110,71,39
2016,5,Sarrià-Sant Gervasi,24,les Tres Torres,25-29,63,36,27
2016,5,Sarrià-Sant Gervasi,25,Sant Gervasi - la Bonanova,25-29,164,57,107
2016,5,Sarrià-Sant Gervasi,26,Sant Gervasi - Galvany,25-29,362,131,231
2016,5,Sarrià-Sant Gervasi,27,el Putxet i el Farró,25-29,240,105,135
2016,6,Gràcia,28,Vallcarca i els Penitents,25-29,118,57,61
2016,6,Gràcia,29,el Coll,25-29,57,31,26
2016,6,Gràcia,30,la Salut,25-29,127,31,96
2016,6,Gràcia,31,la Vila de Gràcia,25-29,836,214,622
2016,6,Gràcia,32,el Camp d'en Grassot i Gràcia Nova,25-29,380,123,257
2016,7,Horta-Guinardó,33,el Baix Guinardó,25-29,255,109,146
2016,7,Horta-Guinardó,34,Can Baró,25-29,73,36,37
2016,7,Horta-Guinardó,35,el Guinardó,25-29,322,126,196
2016,7,Horta-Guinardó,36,la Font d'en Fargues,25-29,36,15,21
2016,7,Horta-Guinardó,37,el Carmel,25-29,218,117,101
2016,7,Horta-Guinardó,38,la Teixonera,25-29,104,49,55
2016,7,Horta-Guinardó,39,Sant Genís dels Agudells,25-29,44,24,20
2016,7,Horta-Guinardó,40,Montbau,25-29,49,15,34
2016,7,Horta-Guinardó,41,la Vall d'Hebron,25-29,25,16,9
2016,7,Horta-Guinardó,42,la Clota,25-29,4,3,1
2016,7,Horta-Guinardó,43,Horta,25-29,223,84,139
2016,8,Nou Barris,44,Vilapicina i la Torre Llobeta,25-29,160,67,93
2016,8,Nou Barris,45,Porta,25-29,154,75,79
2016,8,Nou Barris,46,el Turó de la Peira,25-29,129,39,90
2016,8,Nou Barris,47,Can Peguera,25-29,7,6,1
2016,8,Nou Barris,48,la Guineueta,25-29,68,26,42
2016,8,Nou Barris,49,Canyelles,25-29,14,18,-4
2016,8,Nou Barris,50,les Roquetes,25-29,137,67,70
2016,8,Nou Barris,51,Verdun,25-29,81,50,31
2016,8,Nou Barris,52,la Prosperitat,25-29,192,98,94
2016,8,Nou Barris,53,la Trinitat Nova,25-29,59,33,26
2016,8,Nou Barris,54,Torre Baró,25-29,13,14,-1
2016,8,Nou Barris,55,Ciutat Meridiana,25-29,72,49,23
2016,8,Nou Barris,56,Vallbona,25-29,6,5,1
2016,9,Sant Andreu,57,la Trinitat Vella,25-29,82,48,34
2016,9,Sant Andreu,58,Baró de Viver,25-29,14,11,3
2016,9,Sant Andreu,59,el Bon Pastor,25-29,66,42,24
2016,9,Sant Andreu,60,Sant Andreu,25-29,278,172,106
2016,9,Sant Andreu,61,la Sagrera,25-29,202,93,109
2016,9,Sant Andreu,62,el Congrés i els Indians,25-29,95,34,61
2016,9,Sant Andreu,63,Navas,25-29,156,72,84
2016,10,Sant Martí,64,el Camp de l'Arpa del Clot,25-29,409,145,264
2016,10,Sant Martí,65,el Clot,25-29,229,92,137
2016,10,Sant Martí,66,el Parc i la Llacuna del Poblenou,25-29,179,54,125
2016,10,Sant Martí,67,la Vila Olímpica del Poblenou,25-29,60,19,41
2016,10,Sant Martí,68,el Poblenou,25-29,314,110,204
2016,10,Sant Martí,69,Diagonal Mar i el Front Marítim del Poblenou,25-29,83,20,63
2016,10,Sant Martí,70,el Besòs i el Maresme,25-29,248,139,109
2016,10,Sant Martí,71,Provençals del Poblenou,25-29,132,55,77
2016,10,Sant Martí,72,Sant Martí de Provençals,25-29,165,81,84
2016,10,Sant Martí,73,la Verneda i la Pau,25-29,160,97,63
2016,1,Ciutat Vella,1,el Raval,30-34,864,348,516
2016,1,Ciutat Vella,2,el Barri Gòtic,30-34,345,95,250
2016,1,Ciutat Vella,3,la Barceloneta,30-34,306,113,193
2016,1,Ciutat Vella,4,"Sant Pere, Santa Caterina i la Ribera",30-34,443,178,265
2016,2,Eixample,5,el Fort Pienc,30-34,325,182,143
2016,2,Eixample,6,la Sagrada Família,30-34,521,243,278
2016,2,Eixample,7,la Dreta de l'Eixample,30-34,438,227,211
2016,2,Eixample,8,l'Antiga Esquerra de l'Eixample,30-34,533,233,300
2016,2,Eixample,9,la Nova Esquerra de l'Eixample,30-34,590,292,298
2016,2,Eixample,10,Sant Antoni,30-34,389,158,231
2016,3,Sants-Montjuïc,11,el Poble Sec,30-34,490,238,252
2016,3,Sants-Montjuïc,12,la Marina del Prat Vermell,30-34,8,8,0
2016,3,Sants-Montjuïc,13,la Marina de Port,30-34,164,151,13
2016,3,Sants-Montjuïc,14,la Font de la Guatlla,30-34,95,62,33
2016,3,Sants-Montjuïc,15,Hostafrancs,30-34,186,117,69
2016,3,Sants-Montjuïc,16,la Bordeta,30-34,119,102,17
2016,3,Sants-Montjuïc,17,Sants - Badal,30-34,194,149,45
2016,3,Sants-Montjuïc,18,Sants,30-34,390,265,125
2016,4,Les Corts,19,les Corts,30-34,340,204,136
2016,4,Les Corts,20,la Maternitat i Sant Ramon,30-34,182,113,69
2016,4,Les Corts,21,Pedralbes,30-34,80,48,32
2016,5,Sarrià-Sant Gervasi,22,"Vallvidrera, el Tibidabo i les Planes",30-34,23,20,3
2016,5,Sarrià-Sant Gervasi,23,Sarrià,30-34,142,86,56
2016,5,Sarrià-Sant Gervasi,24,les Tres Torres,30-34,74,54,20
2016,5,Sarrià-Sant Gervasi,25,Sant Gervasi - la Bonanova,30-34,118,73,45
2016,5,Sarrià-Sant Gervasi,26,Sant Gervasi - Galvany,30-34,282,165,117
2016,5,Sarrià-Sant Gervasi,27,el Putxet i el Farró,30-34,219,135,84
2016,6,Gràcia,28,Vallcarca i els Penitents,30-34,112,58,54
2016,6,Gràcia,29,el Coll,30-34,33,31,2
2016,6,Gràcia,30,la Salut,30-34,99,60,39
2016,6,Gràcia,31,la Vila de Gràcia,30-34,630,280,350
2016,6,Gràcia,32,el Camp d'en Grassot i Gràcia Nova,30-34,270,176,94
2016,7,Horta-Guinardó,33,el Baix Guinardó,30-34,166,110,56
2016,7,Horta-Guinardó,34,Can Baró,30-34,46,30,16
2016,7,Horta-Guinardó,35,el Guinardó,30-34,253,175,78
2016,7,Horta-Guinardó,36,la Font d'en Fargues,30-34,26,27,-1
2016,7,Horta-Guinardó,37,el Carmel,30-34,174,130,44
2016,7,Horta-Guinardó,38,la Teixonera,30-34,82,50,32
2016,7,Horta-Guinardó,39,Sant Genís dels Agudells,30-34,43,25,18
2016,7,Horta-Guinardó,40,Montbau,30-34,39,15,24
2016,7,Horta-Guinardó,41,la Vall d'Hebron,30-34,31,15,16
2016,7,Horta-Guinardó,42,la Clota,30-34,1,0,1
2016,7,Horta-Guinardó,43,Horta,30-34,133,72,61
2016,8,Nou Barris,44,Vilapicina i la Torre Llobeta,30-34,123,99,24
2016,8,Nou Barris,45,Porta,30-34,143,94,49
2016,8,Nou Barris,46,el Turó de la Peira,30-34,85,52,33
2016,8,Nou Barris,47,Can Peguera,30-34,5,6,-1
2016,8,Nou Barris,48,la Guineueta,30-34,46,36,10
2016,8,Nou Barris,49,Canyelles,30-34,16,29,-13
2016,8,Nou Barris,50,les Roquetes,30-34,117,76,41
2016,8,Nou Barris,51,Verdun,30-34,91,55,36
2016,8,Nou Barris,52,la Prosperitat,30-34,144,110,34
2016,8,Nou Barris,53,la Trinitat Nova,30-34,51,26,25
2016,8,Nou Barris,54,Torre Baró,30-34,18,10,8
2016,8,Nou Barris,55,Ciutat Meridiana,30-34,88,56,32
2016,8,Nou Barris,56,Vallbona,30-34,12,2,10
2016,9,Sant Andreu,57,la Trinitat Vella,30-34,62,50,12
2016,9,Sant Andreu,58,Baró de Viver,30-34,11,9,2
2016,9,Sant Andreu,59,el Bon Pastor,30-34,60,55,5
2016,9,Sant Andreu,60,Sant Andreu,30-34,265,180,85
2016,9,Sant Andreu,61,la Sagrera,30-34,166,116,50
2016,9,Sant Andreu,62,el Congrés i els Indians,30-34,82,54,28
2016,9,Sant Andreu,63,Navas,30-34,144,92,52
2016,10,Sant Martí,64,el Camp de l'Arpa del Clot,30-34,329,198,131
2016,10,Sant Martí,65,el Clot,30-34,209,117,92
2016,10,Sant Martí,66,el Parc i la Llacuna del Poblenou,30-34,133,80,53
2016,10,Sant Martí,67,la Vila Olímpica del Poblenou,30-34,53,31,22
2016,10,Sant Martí,68,el Poblenou,30-34,311,149,162
2016,10,Sant Martí,69,Diagonal Mar i el Front Marítim del Poblenou,30-34,100,49,51
2016,10,Sant Martí,70,el Besòs i el Maresme,30-34,227,129,98
2016,10,Sant Martí,71,Provençals del Poblenou,30-34,131,91,40
2016,10,Sant Martí,72,Sant Martí de Provençals,30-34,143,112,31
2016,10,Sant Martí,73,la Verneda i la Pau,30-34,141,109,32
2016,1,Ciutat Vella,1,el Raval,35-39,496,319,177
2016,1,Ciutat Vella,2,el Barri Gòtic,35-39,215,120,95
2016,1,Ciutat Vella,3,la Barceloneta,35-39,151,100,51
2016,1,Ciutat Vella,4,"Sant Pere, Santa Caterina i la Ribera",35-39,264,143,121
2016,2,Eixample,5,el Fort Pienc,35-39,221,136,85
2016,2,Eixample,6,la Sagrada Família,35-39,340,265,75
2016,2,Eixample,7,la Dreta de l'Eixample,35-39,305,166,139
2016,2,Eixample,8,l'Antiga Esquerra de l'Eixample,35-39,297,178,119
2016,2,Eixample,9,la Nova Esquerra de l'Eixample,35-39,349,277,72
2016,2,Eixample,10,Sant Antoni,35-39,205,150,55
2016,3,Sants-Montjuïc,11,el Poble Sec,35-39,323,218,105
2016,3,Sants-Montjuïc,12,la Marina del Prat Vermell,35-39,2,6,-4
2016,3,Sants-Montjuïc,13,la Marina de Port,35-39,131,107,24
2016,3,Sants-Montjuïc,14,la Font de la Guatlla,35-39,82,49,33
2016,3,Sants-Montjuïc,15,Hostafrancs,35-39,116,102,14
2016,3,Sants-Montjuïc,16,la Bordeta,35-39,110,80,30
2016,3,Sants-Montjuïc,17,Sants - Badal,35-39,158,142,16
2016,3,Sants-Montjuïc,18,Sants,35-39,266,223,43
2016,4,Les Corts,19,les Corts,35-39,242,158,84
2016,4,Les Corts,20,la Maternitat i Sant Ramon,35-39,124,86,38
2016,4,Les Corts,21,Pedralbes,35-39,81,39,42
2016,5,Sarrià-Sant Gervasi,22,"Vallvidrera, el Tibidabo i les Planes",35-39,19,18,1
2016,5,Sarrià-Sant Gervasi,23,Sarrià,35-39,123,82,41
2016,5,Sarrià-Sant Gervasi,24,les Tres Torres,35-39,51,33,18
2016,5,Sarrià-Sant Gervasi,25,Sant Gervasi - la Bonanova,35-39,107,66,41
2016,5,Sarrià-Sant Gervasi,26,Sant Gervasi - Galvany,35-39,226,127,99
2016,5,Sarrià-Sant Gervasi,27,el Putxet i el Farró,35-39,132,128,4
2016,6,Gràcia,28,Vallcarca i els Penitents,35-39,72,55,17
2016,6,Gràcia,29,el Coll,35-39,36,19,17
2016,6,Gràcia,30,la Salut,35-39,63,48,15
2016,6,Gràcia,31,la Vila de Gràcia,35-39,327,247,80
2016,6,Gràcia,32,el Camp d'en Grassot i Gràcia Nova,35-39,161,123,38
2016,7,Horta-Guinardó,33,el Baix Guinardó,35-39,117,61,56
2016,7,Horta-Guinardó,34,Can Baró,35-39,52,31,21
2016,7,Horta-Guinardó,35,el Guinardó,35-39,176,130,46
2016,7,Horta-Guinardó,36,la Font d'en Fargues,35-39,21,29,-8
2016,7,Horta-Guinardó,37,el Carmel,35-39,106,116,-10
2016,7,Horta-Guinardó,38,la Teixonera,35-39,55,40,15
2016,7,Horta-Guinardó,39,Sant Genís dels Agudells,35-39,41,9,32
2016,7,Horta-Guinardó,40,Montbau,35-39,28,16,12
2016,7,Horta-Guinardó,41,la Vall d'Hebron,35-39,29,11,18
2016,7,Horta-Guinardó,42,la Clota,35-39,5,2,3
2016,7,Horta-Guinardó,43,Horta,35-39,97,84,13
2016,8,Nou Barris,44,Vilapicina i la Torre Llobeta,35-39,102,90,12
2016,8,Nou Barris,45,Porta,35-39,135,70,65
2016,8,Nou Barris,46,el Turó de la Peira,35-39,72,50,22
2016,8,Nou Barris,47,Can Peguera,35-39,5,4,1
2016,8,Nou Barris,48,la Guineueta,35-39,56,23,33
2016,8,Nou Barris,49,Canyelles,35-39,25,20,5
2016,8,Nou Barris,50,les Roquetes,35-39,92,58,34
2016,8,Nou Barris,51,Verdun,35-39,71,54,17
2016,8,Nou Barris,52,la Prosperitat,35-39,119,92,27
2016,8,Nou Barris,53,la Trinitat Nova,35-39,37,35,2
2016,8,Nou Barris,54,Torre Baró,35-39,17,11,6
2016,8,Nou Barris,55,Ciutat Meridiana,35-39,64,46,18
2016,8,Nou Barris,56,Vallbona,35-39,8,2,6
2016,9,Sant Andreu,57,la Trinitat Vella,35-39,61,61,0
2016,9,Sant Andreu,58,Baró de Viver,35-39,4,10,-6
2016,9,Sant Andreu,59,el Bon Pastor,35-39,53,50,3
2016,9,Sant Andreu,60,Sant Andreu,35-39,193,199,-6
2016,9,Sant Andreu,61,la Sagrera,35-39,142,106,36
2016,9,Sant Andreu,62,el Congrés i els Indians,35-39,71,53,18
2016,9,Sant Andreu,63,Navas,35-39,94,71,23
2016,10,Sant Martí,64,el Camp de l'Arpa del Clot,35-39,207,173,34
2016,10,Sant Martí,65,el Clot,35-39,132,110,22
2016,10,Sant Martí,66,el Parc i la Llacuna del Poblenou,35-39,95,62,33
2016,10,Sant Martí,67,la Vila Olímpica del Poblenou,35-39,60,29,31
2016,10,Sant Martí,68,el Poblenou,35-39,224,151,73
2016,10,Sant Martí,69,Diagonal Mar i el Front Marítim del Poblenou,35-39,91,58,33
2016,10,Sant Martí,70,el Besòs i el Maresme,35-39,180,135,45
2016,10,Sant Martí,71,Provençals del Poblenou,35-39,107,82,25
2016,10,Sant Martí,72,Sant Martí de Provençals,35-39,98,90,8
2016,10,Sant Martí,73,la Verneda i la Pau,35-39,99,84,15
2016,1,Ciutat Vella,1,el Raval,40-44,322,220,102
2016,1,Ciutat Vella,2,el Barri Gòtic,40-44,118,97,21
2016,1,Ciutat Vella,3,la Barceloneta,40-44,90,75,15
2016,1,Ciutat Vella,4,"Sant Pere, Santa Caterina i la Ribera",40-44,144,99,45
2016,2,Eixample,5,el Fort Pienc,40-44,111,95,16
2016,2,Eixample,6,la Sagrada Família,40-44,195,153,42
2016,2,Eixample,7,la Dreta de l'Eixample,40-44,192,145,47
2016,2,Eixample,8,l'Antiga Esquerra de l'Eixample,40-44,166,121,45
2016,2,Eixample,9,la Nova Esquerra de l'Eixample,40-44,231,168,63
2016,2,Eixample,10,Sant Antoni,40-44,139,125,14
2016,3,Sants-Montjuïc,11,el Poble Sec,40-44,176,173,3
2016,3,Sants-Montjuïc,12,la Marina del Prat Vermell,40-44,2,1,1
2016,3,Sants-Montjuïc,13,la Marina de Port,40-44,113,87,26
2016,3,Sants-Montjuïc,14,la Font de la Guatlla,40-44,38,33,5
2016,3,Sants-Montjuïc,15,Hostafrancs,40-44,73,54,19
2016,3,Sants-Montjuïc,16,la Bordeta,40-44,80,46,34
2016,3,Sants-Montjuïc,17,Sants - Badal,40-44,102,91,11
2016,3,Sants-Montjuïc,18,Sants,40-44,161,145,16
2016,4,Les Corts,19,les Corts,40-44,149,136,13
2016,4,Les Corts,20,la Maternitat i Sant Ramon,40-44,75,77,-2
2016,4,Les Corts,21,Pedralbes,40-44,70,25,45
2016,5,Sarrià-Sant Gervasi,22,"Vallvidrera, el Tibidabo i les Planes",40-44,16,8,8
2016,5,Sarrià-Sant Gervasi,23,Sarrià,40-44,106,68,38
2016,5,Sarrià-Sant Gervasi,24,les Tres Torres,40-44,68,60,8
2016,5,Sarrià-Sant Gervasi,25,Sant Gervasi - la Bonanova,40-44,91,58,33
2016,5,Sarrià-Sant Gervasi,26,Sant Gervasi - Galvany,40-44,184,128,56
2016,5,Sarrià-Sant Gervasi,27,el Putxet i el Farró,40-44,91,72,19
2016,6,Gràcia,28,Vallcarca i els Penitents,40-44,53,42,11
2016,6,Gràcia,29,el Coll,40-44,31,38,-7
2016,6,Gràcia,30,la Salut,40-44,26,20,6
2016,6,Gràcia,31,la Vila de Gràcia,40-44,169,177,-8
2016,6,Gràcia,32,el Camp d'en Grassot i Gràcia Nova,40-44,95,82,13
2016,7,Horta-Guinardó,33,el Baix Guinardó,40-44,66,75,-9
2016,7,Horta-Guinardó,34,Can Baró,40-44,31,24,7
2016,7,Horta-Guinardó,35,el Guinardó,40-44,122,98,24
2016,7,Horta-Guinardó,36,la Font d'en Fargues,40-44,21,27,-6
2016,7,Horta-Guinardó,37,el Carmel,40-44,99,81,18
2016,7,Horta-Guinardó,38,la Teixonera,40-44,38,31,7
2016,7,Horta-Guinardó,39,Sant Genís dels Agudells,40-44,17,19,-2
2016,7,Horta-Guinardó,40,Montbau,40-44,9,9,0
2016,7,Horta-Guinardó,41,la Vall d'Hebron,40-44,13,10,3
2016,7,Horta-Guinardó,42,la Clota,40-44,5,2,3
2016,7,Horta-Guinardó,43,Horta,40-44,70,58,12
2016,8,Nou Barris,44,Vilapicina i la Torre Llobeta,40-44,77,61,16
2016,8,Nou Barris,45,Porta,40-44,108,58,50
2016,8,Nou Barris,46,el Turó de la Peira,40-44,37,47,-10
2016,8,Nou Barris,47,Can Peguera,40-44,5,3,2
2016,8,Nou Barris,48,la Guineueta,40-44,51,22,29
2016,8,Nou Barris,49,Canyelles,40-44,10,10,0
2016,8,Nou Barris,50,les Roquetes,40-44,63,39,24
2016,8,Nou Barris,51,Verdun,40-44,38,35,3
2016,8,Nou Barris,52,la Prosperitat,40-44,74,63,11
2016,8,Nou Barris,53,la Trinitat Nova,40-44,31,19,12
2016,8,Nou Barris,54,Torre Baró,40-44,10,5,5
2016,8,Nou Barris,55,Ciutat Meridiana,40-44,57,33,24
2016,8,Nou Barris,56,Vallbona,40-44,2,7,-5
2016,9,Sant Andreu,57,la Trinitat Vella,40-44,54,34,20
2016,9,Sant Andreu,58,Baró de Viver,40-44,8,7,1
2016,9,Sant Andreu,59,el Bon Pastor,40-44,43,44,-1
2016,9,Sant Andreu,60,Sant Andreu,40-44,134,139,-5
2016,9,Sant Andreu,61,la Sagrera,40-44,86,60,26
2016,9,Sant Andreu,62,el Congrés i els Indians,40-44,38,33,5
2016,9,Sant Andreu,63,Navas,40-44,70,65,5
2016,10,Sant Martí,64,el Camp de l'Arpa del Clot,40-44,146,133,13
2016,10,Sant Martí,65,el Clot,40-44,72,75,-3
2016,10,Sant Martí,66,el Parc i la Llacuna del Poblenou,40-44,59,43,16
2016,10,Sant Martí,67,la Vila Olímpica del Poblenou,40-44,37,18,19
2016,10,Sant Martí,68,el Poblenou,40-44,146,114,32
2016,10,Sant Martí,69,Diagonal Mar i el Front Marítim del Poblenou,40-44,72,50,22
2016,10,Sant Martí,70,el Besòs i el Maresme,40-44,126,95,31
2016,10,Sant Martí,71,Provençals del Poblenou,40-44,66,72,-6
2016,10,Sant Martí,72,Sant Martí de Provençals,40-44,57,58,-1
2016,10,Sant Martí,73,la Verneda i la Pau,40-44,89,67,22
2016,1,Ciutat Vella,1,el Raval,45-49,213,163,50
2016,1,Ciutat Vella,2,el Barri Gòtic,45-49,68,47,21
2016,1,Ciutat Vella,3,la Barceloneta,45-49,47,33,14
2016,1,Ciutat Vella,4,"Sant Pere, Santa Caterina i la Ribera",45-49,71,66,5
2016,2,Eixample,5,el Fort Pienc,45-49,81,54,27
2016,2,Eixample,6,la Sagrada Família,45-49,131,112,19
2016,2,Eixample,7,la Dreta de l'Eixample,45-49,133,88,45
2016,2,Eixample,8,l'Antiga Esquerra de l'Eixample,45-49,109,73,36
2016,2,Eixample,9,la Nova Esquerra de l'Eixample,45-49,128,121,7
2016,2,Eixample,10,Sant Antoni,45-49,78,59,19
2016,3,Sants-Montjuïc,11,el Poble Sec,45-49,122,112,10
2016,3,Sants-Montjuïc,12,la Marina del Prat Vermell,45-49,1,2,-1
2016,3,Sants-Montjuïc,13,la Marina de Port,45-49,78,62,16
2016,3,Sants-Montjuïc,14,la Font de la Guatlla,45-49,33,24,9
2016,3,Sants-Montjuïc,15,Hostafrancs,45-49,56,58,-2
2016,3,Sants-Montjuïc,16,la Bordeta,45-49,37,49,-12
2016,3,Sants-Montjuïc,17,Sants - Badal,45-49,58,55,3
2016,3,Sants-Montjuïc,18,Sants,45-49,107,94,13
2016,4,Les Corts,19,les Corts,45-49,101,86,15
2016,4,Les Corts,20,la Maternitat i Sant Ramon,45-49,63,53,10
2016,4,Les Corts,21,Pedralbes,45-49,45,38,7
2016,5,Sarrià-Sant Gervasi,22,"Vallvidrera, el Tibidabo i les Planes",45-49,6,10,-4
2016,5,Sarrià-Sant Gervasi,23,Sarrià,45-49,72,52,20
2016,5,Sarrià-Sant Gervasi,24,les Tres Torres,45-49,37,33,4
2016,5,Sarrià-Sant Gervasi,25,Sant Gervasi - la Bonanova,45-49,49,55,-6
2016,5,Sarrià-Sant Gervasi,26,Sant Gervasi - Galvany,45-49,148,81,67
2016,5,Sarrià-Sant Gervasi,27,el Putxet i el Farró,45-49,62,57,5
2016,6,Gràcia,28,Vallcarca i els Penitents,45-49,37,31,6
2016,6,Gràcia,29,el Coll,45-49,19,14,5
2016,6,Gràcia,30,la Salut,45-49,20,19,1
2016,6,Gràcia,31,la Vila de Gràcia,45-49,103,104,-1
2016,6,Gràcia,32,el Camp d'en Grassot i Gràcia Nova,45-49,65,43,22
2016,7,Horta-Guinardó,33,el Baix Guinardó,45-49,47,48,-1
2016,7,Horta-Guinardó,34,Can Baró,45-49,22,10,12
2016,7,Horta-Guinardó,35,el Guinardó,45-49,96,80,16
2016,7,Horta-Guinardó,36,la Font d'en Fargues,45-49,11,14,-3
2016,7,Horta-Guinardó,37,el Carmel,45-49,54,55,-1
2016,7,Horta-Guinardó,38,la Teixonera,45-49,21,15,6
2016,7,Horta-Guinardó,39,Sant Genís dels Agudells,45-49,19,13,6
2016,7,Horta-Guinardó,40,Montbau,45-49,6,13,-7
2016,7,Horta-Guinardó,41,la Vall d'Hebron,45-49,14,7,7
2016,7,Horta-Guinardó,42,la Clota,45-49,0,0,0
2016,7,Horta-Guinardó,43,Horta,45-49,49,42,7
2016,8,Nou Barris,44,Vilapicina i la Torre Llobeta,45-49,43,28,15
2016,8,Nou Barris,45,Porta,45-49,71,57,14
2016,8,Nou Barris,46,el Turó de la Peira,45-49,40,32,8
2016,8,Nou Barris,47,Can Peguera,45-49,2,7,-5
2016,8,Nou Barris,48,la Guineueta,45-49,31,24,7
2016,8,Nou Barris,49,Canyelles,45-49,4,11,-7
2016,8,Nou Barris,50,les Roquetes,45-49,47,43,4
2016,8,Nou Barris,51,Verdun,45-49,28,22,6
2016,8,Nou Barris,52,la Prosperitat,45-49,62,39,23
2016,8,Nou Barris,53,la Trinitat Nova,45-49,15,16,-1
2016,8,Nou Barris,54,Torre Baró,45-49,10,2,8
2016,8,Nou Barris,55,Ciutat Meridiana,45-49,31,20,11
2016,8,Nou Barris,56,Vallbona,45-49,3,4,-1
2016,9,Sant Andreu,57,la Trinitat Vella,45-49,39,20,19
2016,9,Sant Andreu,58,Baró de Viver,45-49,10,6,4
2016,9,Sant Andreu,59,el Bon Pastor,45-49,33,33,0
2016,9,Sant Andreu,60,Sant Andreu,45-49,96,75,21
2016,9,Sant Andreu,61,la Sagrera,45-49,61,43,18
2016,9,Sant Andreu,62,el Congrés i els Indians,45-49,33,23,10
2016,9,Sant Andreu,63,Navas,45-49,49,51,-2
2016,10,Sant Martí,64,el Camp de l'Arpa del Clot,45-49,92,93,-1
2016,10,Sant Martí,65,el Clot,45-49,58,45,13
2016,10,Sant Martí,66,el Parc i la Llacuna del Poblenou,45-49,39,24,15
2016,10,Sant Martí,67,la Vila Olímpica del Poblenou,45-49,17,18,-1
2016,10,Sant Martí,68,el Poblenou,45-49,80,58,22
2016,10,Sant Martí,69,Diagonal Mar i el Front Marítim del Poblenou,45-49,45,29,16
2016,10,Sant Martí,70,el Besòs i el Maresme,45-49,94,74,20
2016,10,Sant Martí,71,Provençals del Poblenou,45-49,43,33,10
2016,10,Sant Martí,72,Sant Martí de Provençals,45-49,51,53,-2
2016,10,Sant Martí,73,la Verneda i la Pau,45-49,79,55,24
2016,1,Ciutat Vella,1,el Raval,50-54,132,96,36
2016,1,Ciutat Vella,2,el Barri Gòtic,50-54,55,40,15
2016,1,Ciutat Vella,3,la Barceloneta,50-54,33,21,12
2016,1,Ciutat Vella,4,"Sant Pere, Santa Caterina i la Ribera",50-54,51,29,22
2016,2,Eixample,5,el Fort Pienc,50-54,67,41,26
2016,2,Eixample,6,la Sagrada Família,50-54,101,81,20
2016,2,Eixample,7,la Dreta de l'Eixample,50-54,118,70,48
2016,2,Eixample,8,l'Antiga Esquerra de l'Eixample,50-54,78,76,2
2016,2,Eixample,9,la Nova Esquerra de l'Eixample,50-54,105,73,32
2016,2,Eixample,10,Sant Antoni,50-54,74,56,18
2016,3,Sants-Montjuïc,11,el Poble Sec,50-54,94,78,16
2016,3,Sants-Montjuïc,12,la Marina del Prat Vermell,50-54,1,1,0
2016,3,Sants-Montjuïc,13,la Marina de Port,50-54,59,50,9
2016,3,Sants-Montjuïc,14,la Font de la Guatlla,50-54,12,20,-8
2016,3,Sants-Montjuïc,15,Hostafrancs,50-54,26,30,-4
2016,3,Sants-Montjuïc,16,la Bordeta,50-54,29,19,10
2016,3,Sants-Montjuïc,17,Sants - Badal,50-54,39,50,-11
2016,3,Sants-Montjuïc,18,Sants,50-54,87,66,21
2016,4,Les Corts,19,les Corts,50-54,59,66,-7
2016,4,Les Corts,20,la Maternitat i Sant Ramon,50-54,45,33,12
2016,4,Les Corts,21,Pedralbes,50-54,36,23,13
2016,5,Sarrià-Sant Gervasi,22,"Vallvidrera, el Tibidabo i les Planes",50-54,7,6,1
2016,5,Sarrià-Sant Gervasi,23,Sarrià,50-54,50,45,5
2016,5,Sarrià-Sant Gervasi,24,les Tres Torres,50-54,32,22,10
2016,5,Sarrià-Sant Gervasi,25,Sant Gervasi - la Bonanova,50-54,46,39,7
2016,5,Sarrià-Sant Gervasi,26,Sant Gervasi - Galvany,50-54,122,67,55
2016,5,Sarrià-Sant Gervasi,27,el Putxet i el Farró,50-54,47,40,7
2016,6,Gràcia,28,Vallcarca i els Penitents,50-54,27,18,9
2016,6,Gràcia,29,el Coll,50-54,9,11,-2
2016,6,Gràcia,30,la Salut,50-54,18,15,3
2016,6,Gràcia,31,la Vila de Gràcia,50-54,85,78,7
2016,6,Gràcia,32,el Camp d'en Grassot i Gràcia Nova,50-54,39,30,9
2016,7,Horta-Guinardó,33,el Baix Guinardó,50-54,29,21,8
2016,7,Horta-Guinardó,34,Can Baró,50-54,14,17,-3
2016,7,Horta-Guinardó,35,el Guinardó,50-54,57,43,14
2016,7,Horta-Guinardó,36,la Font d'en Fargues,50-54,6,7,-1
2016,7,Horta-Guinardó,37,el Carmel,50-54,54,40,14
2016,7,Horta-Guinardó,38,la Teixonera,50-54,19,17,2
2016,7,Horta-Guinardó,39,Sant Genís dels Agudells,50-54,12,9,3
2016,7,Horta-Guinardó,40,Montbau,50-54,7,6,1
2016,7,Horta-Guinardó,41,la Vall d'Hebron,50-54,9,9,0
2016,7,Horta-Guinardó,42,la Clota,50-54,1,0,1
2016,7,Horta-Guinardó,43,Horta,50-54,45,35,10
2016,8,Nou Barris,44,Vilapicina i la Torre Llobeta,50-54,40,31,9
2016,8,Nou Barris,45,Porta,50-54,46,40,6
2016,8,Nou Barris,46,el Turó de la Peira,50-54,32,18,14
2016,8,Nou Barris,47,Can Peguera,50-54,6,3,3
2016,8,Nou Barris,48,la Guineueta,50-54,17,14,3
2016,8,Nou Barris,49,Canyelles,50-54,7,4,3
2016,8,Nou Barris,50,les Roquetes,50-54,25,21,4
2016,8,Nou Barris,51,Verdun,50-54,27,13,14
2016,8,Nou Barris,52,la Prosperitat,50-54,48,33,15
2016,8,Nou Barris,53,la Trinitat Nova,50-54,14,15,-1
2016,8,Nou Barris,54,Torre Baró,50-54,10,3,7
2016,8,Nou Barris,55,Ciutat Meridiana,50-54,30,17,13
2016,8,Nou Barris,56,Vallbona,50-54,0,1,-1
2016,9,Sant Andreu,57,la Trinitat Vella,50-54,28,16,12
2016,9,Sant Andreu,58,Baró de Viver,50-54,4,3,1
2016,9,Sant Andreu,59,el Bon Pastor,50-54,18,23,-5
2016,9,Sant Andreu,60,Sant Andreu,50-54,72,54,18
2016,9,Sant Andreu,61,la Sagrera,50-54,46,35,11
2016,9,Sant Andreu,62,el Congrés i els Indians,50-54,25,17,8
2016,9,Sant Andreu,63,Navas,50-54,40,26,14
2016,10,Sant Martí,64,el Camp de l'Arpa del Clot,50-54,64,61,3
2016,10,Sant Martí,65,el Clot,50-54,46,36,10
2016,10,Sant Martí,66,el Parc i la Llacuna del Poblenou,50-54,15,31,-16
2016,10,Sant Martí,67,la Vila Olímpica del Poblenou,50-54,15,14,1
2016,10,Sant Martí,68,el Poblenou,50-54,49,54,-5
2016,10,Sant Martí,69,Diagonal Mar i el Front Marítim del Poblenou,50-54,31,15,16
2016,10,Sant Martí,70,el Besòs i el Maresme,50-54,69,48,21
2016,10,Sant Martí,71,Provençals del Poblenou,50-54,40,35,5
2016,10,Sant Martí,72,Sant Martí de Provençals,50-54,50,39,11
2016,10,Sant Martí,73,la Verneda i la Pau,50-54,48,29,19
2016,1,Ciutat Vella,1,el Raval,55-59,96,60,36
2016,1,Ciutat Vella,2,el Barri Gòtic,55-59,41,27,14
2016,1,Ciutat Vella,3,la Barceloneta,55-59,29,27,2
2016,1,Ciutat Vella,4,"Sant Pere, Santa Caterina i la Ribera",55-59,36,21,15
2016,2,Eixample,5,el Fort Pienc,55-59,55,36,19
2016,2,Eixample,6,la Sagrada Família,55-59,68,59,9
2016,2,Eixample,7,la Dreta de l'Eixample,55-59,73,65,8
2016,2,Eixample,8,l'Antiga Esquerra de l'Eixample,55-59,60,44,16
2016,2,Eixample,9,la Nova Esquerra de l'Eixample,55-59,87,52,35
2016,2,Eixample,10,Sant Antoni,55-59,51,60,-9
2016,3,Sants-Montjuïc,11,el Poble Sec,55-59,75,54,21
2016,3,Sants-Montjuïc,12,la Marina del Prat Vermell,55-59,0,3,-3
2016,3,Sants-Montjuïc,13,la Marina de Port,55-59,37,39,-2
2016,3,Sants-Montjuïc,14,la Font de la Guatlla,55-59,11,13,-2
2016,3,Sants-Montjuïc,15,Hostafrancs,55-59,20,20,0
2016,3,Sants-Montjuïc,16,la Bordeta,55-59,35,27,8
2016,3,Sants-Montjuïc,17,Sants - Badal,55-59,29,43,-14
2016,3,Sants-Montjuïc,18,Sants,55-59,56,55,1
2016,4,Les Corts,19,les Corts,55-59,47,53,-6
2016,4,Les Corts,20,la Maternitat i Sant Ramon,55-59,37,35,2
2016,4,Les Corts,21,Pedralbes,55-59,32,16,16
2016,5,Sarrià-Sant Gervasi,22,"Vallvidrera, el Tibidabo i les Planes",55-59,9,3,6
2016,5,Sarrià-Sant Gervasi,23,Sarrià,55-59,37,35,2
2016,5,Sarrià-Sant Gervasi,24,les Tres Torres,55-59,18,21,-3
2016,5,Sarrià-Sant Gervasi,25,Sant Gervasi - la Bonanova,55-59,23,30,-7
2016,5,Sarrià-Sant Gervasi,26,Sant Gervasi - Galvany,55-59,60,64,-4
2016,5,Sarrià-Sant Gervasi,27,el Putxet i el Farró,55-59,28,28,0
2016,6,Gràcia,28,Vallcarca i els Penitents,55-59,27,19,8
2016,6,Gràcia,29,el Coll,55-59,10,5,5
2016,6,Gràcia,30,la Salut,55-59,18,8,10
2016,6,Gràcia,31,la Vila de Gràcia,55-59,69,49,20
2016,6,Gràcia,32,el Camp d'en Grassot i Gràcia Nova,55-59,19,36,-17
2016,7,Horta-Guinardó,33,el Baix Guinardó,55-59,36,26,10
2016,7,Horta-Guinardó,34,Can Baró,55-59,8,7,1
2016,7,Horta-Guinardó,35,el Guinardó,55-59,46,38,8
2016,7,Horta-Guinardó,36,la Font d'en Fargues,55-59,8,13,-5
2016,7,Horta-Guinardó,37,el Carmel,55-59,26,31,-5
2016,7,Horta-Guinardó,38,la Teixonera,55-59,14,10,4
2016,7,Horta-Guinardó,39,Sant Genís dels Agudells,55-59,11,3,8
2016,7,Horta-Guinardó,40,Montbau,55-59,5,3,2
2016,7,Horta-Guinardó,41,la Vall d'Hebron,55-59,4,4,0
2016,7,Horta-Guinardó,42,la Clota,55-59,0,0,0
2016,7,Horta-Guinardó,43,Horta,55-59,24,22,2
2016,8,Nou Barris,44,Vilapicina i la Torre Llobeta,55-59,34,37,-3
2016,8,Nou Barris,45,Porta,55-59,39,30,9
2016,8,Nou Barris,46,el Turó de la Peira,55-59,26,13,13
2016,8,Nou Barris,47,Can Peguera,55-59,5,2,3
2016,8,Nou Barris,48,la Guineueta,55-59,10,11,-1
2016,8,Nou Barris,49,Canyelles,55-59,4,9,-5
2016,8,Nou Barris,50,les Roquetes,55-59,26,16,10
2016,8,Nou Barris,51,Verdun,55-59,23,16,7
2016,8,Nou Barris,52,la Prosperitat,55-59,28,18,10
2016,8,Nou Barris,53,la Trinitat Nova,55-59,14,12,2
2016,8,Nou Barris,54,Torre Baró,55-59,3,2,1
2016,8,Nou Barris,55,Ciutat Meridiana,55-59,16,12,4
2016,8,Nou Barris,56,Vallbona,55-59,3,3,0
2016,9,Sant Andreu,57,la Trinitat Vella,55-59,13,15,-2
2016,9,Sant Andreu,58,Baró de Viver,55-59,3,5,-2
2016,9,Sant Andreu,59,el Bon Pastor,55-59,19,20,-1
2016,9,Sant Andreu,60,Sant Andreu,55-59,66,58,8
2016,9,Sant Andreu,61,la Sagrera,55-59,28,26,2
2016,9,Sant Andreu,62,el Congrés i els Indians,55-59,18,14,4
2016,9,Sant Andreu,63,Navas,55-59,32,19,13
2016,10,Sant Martí,64,el Camp de l'Arpa del Clot,55-59,50,48,2
2016,10,Sant Martí,65,el Clot,55-59,29,33,-4
2016,10,Sant Martí,66,el Parc i la Llacuna del Poblenou,55-59,17,19,-2
2016,10,Sant Martí,67,la Vila Olímpica del Poblenou,55-59,15,9,6
2016,10,Sant Martí,68,el Poblenou,55-59,28,32,-4
2016,10,Sant Martí,69,Diagonal Mar i el Front Marítim del Poblenou,55-59,25,7,18
2016,10,Sant Martí,70,el Besòs i el Maresme,55-59,36,28,8
2016,10,Sant Martí,71,Provençals del Poblenou,55-59,31,29,2
2016,10,Sant Martí,72,Sant Martí de Provençals,55-59,37,33,4
2016,10,Sant Martí,73,la Verneda i la Pau,55-59,34,31,3
2016,1,Ciutat Vella,1,el Raval,60-64,84,51,33
2016,1,Ciutat Vella,2,el Barri Gòtic,60-64,32,16,16
2016,1,Ciutat Vella,3,la Barceloneta,60-64,29,20,9
2016,1,Ciutat Vella,4,"Sant Pere, Santa Caterina i la Ribera",60-64,26,17,9
2016,2,Eixample,5,el Fort Pienc,60-64,32,29,3
2016,2,Eixample,6,la Sagrada Família,60-64,57,53,4
2016,2,Eixample,7,la Dreta de l'Eixample,60-64,61,47,14
2016,2,Eixample,8,l'Antiga Esquerra de l'Eixample,60-64,45,47,-2
2016,2,Eixample,9,la Nova Esquerra de l'Eixample,60-64,56,57,-1
2016,2,Eixample,10,Sant Antoni,60-64,37,29,8
2016,3,Sants-Montjuïc,11,el Poble Sec,60-64,35,39,-4
2016,3,Sants-Montjuïc,12,la Marina del Prat Vermell,60-64,0,1,-1
2016,3,Sants-Montjuïc,13,la Marina de Port,60-64,27,30,-3
2016,3,Sants-Montjuïc,14,la Font de la Guatlla,60-64,15,11,4
2016,3,Sants-Montjuïc,15,Hostafrancs,60-64,13,16,-3
2016,3,Sants-Montjuïc,16,la Bordeta,60-64,29,17,12
2016,3,Sants-Montjuïc,17,Sants - Badal,60-64,24,37,-13
2016,3,Sants-Montjuïc,18,Sants,60-64,39,45,-6
2016,4,Les Corts,19,les Corts,60-64,47,44,3
2016,4,Les Corts,20,la Maternitat i Sant Ramon,60-64,28,27,1
2016,4,Les Corts,21,Pedralbes,60-64,13,22,-9
2016,5,Sarrià-Sant Gervasi,22,"Vallvidrera, el Tibidabo i les Planes",60-64,10,8,2
2016,5,Sarrià-Sant Gervasi,23,Sarrià,60-64,17,18,-1
2016,5,Sarrià-Sant Gervasi,24,les Tres Torres,60-64,12,10,2
2016,5,Sarrià-Sant Gervasi,25,Sant Gervasi - la Bonanova,60-64,20,32,-12
2016,5,Sarrià-Sant Gervasi,26,Sant Gervasi - Galvany,60-64,49,54,-5
2016,5,Sarrià-Sant Gervasi,27,el Putxet i el Farró,60-64,33,41,-8
2016,6,Gràcia,28,Vallcarca i els Penitents,60-64,13,14,-1
2016,6,Gràcia,29,el Coll,60-64,8,7,1
2016,6,Gràcia,30,la Salut,60-64,10,10,0
2016,6,Gràcia,31,la Vila de Gràcia,60-64,48,43,5
2016,6,Gràcia,32,el Camp d'en Grassot i Gràcia Nova,60-64,37,30,7
2016,7,Horta-Guinardó,33,el Baix Guinardó,60-64,24,26,-2
2016,7,Horta-Guinardó,34,Can Baró,60-64,6,10,-4
2016,7,Horta-Guinardó,35,el Guinardó,60-64,27,23,4
2016,7,Horta-Guinardó,36,la Font d'en Fargues,60-64,9,7,2
2016,7,Horta-Guinardó,37,el Carmel,60-64,23,21,2
2016,7,Horta-Guinardó,38,la Teixonera,60-64,5,9,-4
2016,7,Horta-Guinardó,39,Sant Genís dels Agudells,60-64,6,4,2
2016,7,Horta-Guinardó,40,Montbau,60-64,8,6,2
2016,7,Horta-Guinardó,41,la Vall d'Hebron,60-64,10,6,4
2016,7,Horta-Guinardó,42,la Clota,60-64,1,1,0
2016,7,Horta-Guinardó,43,Horta,60-64,18,13,5
2016,8,Nou Barris,44,Vilapicina i la Torre Llobeta,60-64,18,22,-4
2016,8,Nou Barris,45,Porta,60-64,27,27,0
2016,8,Nou Barris,46,el Turó de la Peira,60-64,19,9,10
2016,8,Nou Barris,47,Can Peguera,60-64,2,0,2
2016,8,Nou Barris,48,la Guineueta,60-64,8,8,0
2016,8,Nou Barris,49,Canyelles,60-64,5,9,-4
2016,8,Nou Barris,50,les Roquetes,60-64,16,13,3
2016,8,Nou Barris,51,Verdun,60-64,8,12,-4
2016,8,Nou Barris,52,la Prosperitat,60-64,14,17,-3
2016,8,Nou Barris,53,la Trinitat Nova,60-64,8,7,1
2016,8,Nou Barris,54,Torre Baró,60-64,1,0,1
2016,8,Nou Barris,55,Ciutat Meridiana,60-64,9,7,2
2016,8,Nou Barris,56,Vallbona,60-64,2,1,1
2016,9,Sant Andreu,57,la Trinitat Vella,60-64,10,7,3
2016,9,Sant Andreu,58,Baró de Viver,60-64,1,3,-2
2016,9,Sant Andreu,59,el Bon Pastor,60-64,9,13,-4
2016,9,Sant Andreu,60,Sant Andreu,60-64,40,54,-14
2016,9,Sant Andreu,61,la Sagrera,60-64,29,25,4
2016,9,Sant Andreu,62,el Congrés i els Indians,60-64,12,10,2
2016,9,Sant Andreu,63,Navas,60-64,18,32,-14
2016,10,Sant Martí,64,el Camp de l'Arpa del Clot,60-64,41,45,-4
2016,10,Sant Martí,65,el Clot,60-64,30,29,1
2016,10,Sant Martí,66,el Parc i la Llacuna del Poblenou,60-64,12,13,-1
2016,10,Sant Martí,67,la Vila Olímpica del Poblenou,60-64,8,7,1
2016,10,Sant Martí,68,el Poblenou,60-64,22,17,5
2016,10,Sant Martí,69,Diagonal Mar i el Front Marítim del Poblenou,60-64,9,12,-3
2016,10,Sant Martí,70,el Besòs i el Maresme,60-64,31,14,17
2016,10,Sant Martí,71,Provençals del Poblenou,60-64,19,21,-2
2016,10,Sant Martí,72,Sant Martí de Provençals,60-64,36,20,16
2016,10,Sant Martí,73,la Verneda i la Pau,60-64,24,23,1
2016,1,Ciutat Vella,1,el Raval,65-69,55,36,19
2016,1,Ciutat Vella,2,el Barri Gòtic,65-69,21,10,11
2016,1,Ciutat Vella,3,la Barceloneta,65-69,10,12,-2
2016,1,Ciutat Vella,4,"Sant Pere, Santa Caterina i la Ribera",65-69,11,17,-6
2016,2,Eixample,5,el Fort Pienc,65-69,20,23,-3
2016,2,Eixample,6,la Sagrada Família,65-69,42,36,6
2016,2,Eixample,7,la Dreta de l'Eixample,65-69,54,42,12
2016,2,Eixample,8,l'Antiga Esquerra de l'Eixample,65-69,40,50,-10
2016,2,Eixample,9,la Nova Esquerra de l'Eixample,65-69,55,64,-9
2016,2,Eixample,10,Sant Antoni,65-69,25,36,-11
2016,3,Sants-Montjuïc,11,el Poble Sec,65-69,40,53,-13
2016,3,Sants-Montjuïc,12,la Marina del Prat Vermell,65-69,0,0,0
2016,3,Sants-Montjuïc,13,la Marina de Port,65-69,19,23,-4
2016,3,Sants-Montjuïc,14,la Font de la Guatlla,65-69,7,14,-7
2016,3,Sants-Montjuïc,15,Hostafrancs,65-69,14,22,-8
2016,3,Sants-Montjuïc,16,la Bordeta,65-69,20,20,0
2016,3,Sants-Montjuïc,17,Sants - Badal,65-69,20,27,-7
2016,3,Sants-Montjuïc,18,Sants,65-69,36,34,2
2016,4,Les Corts,19,les Corts,65-69,34,47,-13
2016,4,Les Corts,20,la Maternitat i Sant Ramon,65-69,27,23,4
2016,4,Les Corts,21,Pedralbes,65-69,13,10,3
2016,5,Sarrià-Sant Gervasi,22,"Vallvidrera, el Tibidabo i les Planes",65-69,2,0,2
2016,5,Sarrià-Sant Gervasi,23,Sarrià,65-69,18,22,-4
2016,5,Sarrià-Sant Gervasi,24,les Tres Torres,65-69,11,19,-8
2016,5,Sarrià-Sant Gervasi,25,Sant Gervasi - la Bonanova,65-69,25,23,2
2016,5,Sarrià-Sant Gervasi,26,Sant Gervasi - Galvany,65-69,38,52,-14
2016,5,Sarrià-Sant Gervasi,27,el Putxet i el Farró,65-69,25,40,-15
2016,6,Gràcia,28,Vallcarca i els Penitents,65-69,11,12,-1
2016,6,Gràcia,29,el Coll,65-69,9,10,-1
2016,6,Gràcia,30,la Salut,65-69,14,10,4
2016,6,Gràcia,31,la Vila de Gràcia,65-69,32,45,-13
2016,6,Gràcia,32,el Camp d'en Grassot i Gràcia Nova,65-69,26,21,5
2016,7,Horta-Guinardó,33,el Baix Guinardó,65-69,19,15,4
2016,7,Horta-Guinardó,34,Can Baró,65-69,5,15,-10
2016,7,Horta-Guinardó,35,el Guinardó,65-69,22,33,-11
2016,7,Horta-Guinardó,36,la Font d'en Fargues,65-69,5,9,-4
2016,7,Horta-Guinardó,37,el Carmel,65-69,23,22,1
2016,7,Horta-Guinardó,38,la Teixonera,65-69,3,10,-7
2016,7,Horta-Guinardó,39,Sant Genís dels Agudells,65-69,4,7,-3
2016,7,Horta-Guinardó,40,Montbau,65-69,3,2,1
2016,7,Horta-Guinardó,41,la Vall d'Hebron,65-69,6,5,1
2016,7,Horta-Guinardó,42,la Clota,65-69,0,0,0
2016,7,Horta-Guinardó,43,Horta,65-69,10,21,-11
2016,8,Nou Barris,44,Vilapicina i la Torre Llobeta,65-69,22,22,0
2016,8,Nou Barris,45,Porta,65-69,15,14,1
2016,8,Nou Barris,46,el Turó de la Peira,65-69,15,14,1
2016,8,Nou Barris,47,Can Peguera,65-69,2,0,2
2016,8,Nou Barris,48,la Guineueta,65-69,4,5,-1
2016,8,Nou Barris,49,Canyelles,65-69,2,1,1
2016,8,Nou Barris,50,les Roquetes,65-69,17,16,1
2016,8,Nou Barris,51,Verdun,65-69,10,6,4
2016,8,Nou Barris,52,la Prosperitat,65-69,18,16,2
2016,8,Nou Barris,53,la Trinitat Nova,65-69,9,9,0
2016,8,Nou Barris,54,Torre Baró,65-69,1,1,0
2016,8,Nou Barris,55,Ciutat Meridiana,65-69,4,11,-7
2016,8,Nou Barris,56,Vallbona,65-69,0,2,-2
2016,9,Sant Andreu,57,la Trinitat Vella,65-69,5,4,1
2016,9,Sant Andreu,58,Baró de Viver,65-69,1,3,-2
2016,9,Sant Andreu,59,el Bon Pastor,65-69,7,12,-5
2016,9,Sant Andreu,60,Sant Andreu,65-69,48,42,6
2016,9,Sant Andreu,61,la Sagrera,65-69,20,22,-2
2016,9,Sant Andreu,62,el Congrés i els Indians,65-69,9,5,4
2016,9,Sant Andreu,63,Navas,65-69,21,20,1
2016,10,Sant Martí,64,el Camp de l'Arpa del Clot,65-69,27,32,-5
2016,10,Sant Martí,65,el Clot,65-69,19,26,-7
2016,10,Sant Martí,66,el Parc i la Llacuna del Poblenou,65-69,9,13,-4
2016,10,Sant Martí,67,la Vila Olímpica del Poblenou,65-69,6,11,-5
2016,10,Sant Martí,68,el Poblenou,65-69,25,20,5
2016,10,Sant Martí,69,Diagonal Mar i el Front Marítim del Poblenou,65-69,19,12,7
2016,10,Sant Martí,70,el Besòs i el Maresme,65-69,22,20,2
2016,10,Sant Martí,71,Provençals del Poblenou,65-69,10,10,0
2016,10,Sant Martí,72,Sant Martí de Provençals,65-69,17,20,-3
2016,10,Sant Martí,73,la Verneda i la Pau,65-69,13,14,-1
2016,1,Ciutat Vella,1,el Raval,70-74,28,19,9
2016,1,Ciutat Vella,2,el Barri Gòtic,70-74,10,10,0
2016,1,Ciutat Vella,3,la Barceloneta,70-74,13,5,8
2016,1,Ciutat Vella,4,"Sant Pere, Santa Caterina i la Ribera",70-74,12,14,-2
2016,2,Eixample,5,el Fort Pienc,70-74,24,20,4
2016,2,Eixample,6,la Sagrada Família,70-74,35,23,12
2016,2,Eixample,7,la Dreta de l'Eixample,70-74,34,44,-10
2016,2,Eixample,8,l'Antiga Esquerra de l'Eixample,70-74,22,18,4
2016,2,Eixample,9,la Nova Esquerra de l'Eixample,70-74,31,37,-6
2016,2,Eixample,10,Sant Antoni,70-74,11,18,-7
2016,3,Sants-Montjuïc,11,el Poble Sec,70-74,14,20,-6
2016,3,Sants-Montjuïc,12,la Marina del Prat Vermell,70-74,0,0,0
2016,3,Sants-Montjuïc,13,la Marina de Port,70-74,15,19,-4
2016,3,Sants-Montjuïc,14,la Font de la Guatlla,70-74,6,1,5
2016,3,Sants-Montjuïc,15,Hostafrancs,70-74,12,16,-4
2016,3,Sants-Montjuïc,16,la Bordeta,70-74,13,18,-5
2016,3,Sants-Montjuïc,17,Sants - Badal,70-74,17,13,4
2016,3,Sants-Montjuïc,18,Sants,70-74,19,15,4
2016,4,Les Corts,19,les Corts,70-74,20,32,-12
2016,4,Les Corts,20,la Maternitat i Sant Ramon,70-74,17,17,0
2016,4,Les Corts,21,Pedralbes,70-74,4,5,-1
2016,5,Sarrià-Sant Gervasi,22,"Vallvidrera, el Tibidabo i les Planes",70-74,1,5,-4
2016,5,Sarrià-Sant Gervasi,23,Sarrià,70-74,9,8,1
2016,5,Sarrià-Sant Gervasi,24,les Tres Torres,70-74,9,14,-5
2016,5,Sarrià-Sant Gervasi,25,Sant Gervasi - la Bonanova,70-74,16,19,-3
2016,5,Sarrià-Sant Gervasi,26,Sant Gervasi - Galvany,70-74,23,30,-7
2016,5,Sarrià-Sant Gervasi,27,el Putxet i el Farró,70-74,14,34,-20
2016,6,Gràcia,28,Vallcarca i els Penitents,70-74,10,15,-5
2016,6,Gràcia,29,el Coll,70-74,5,7,-2
2016,6,Gràcia,30,la Salut,70-74,9,11,-2
2016,6,Gràcia,31,la Vila de Gràcia,70-74,23,25,-2
2016,6,Gràcia,32,el Camp d'en Grassot i Gràcia Nova,70-74,21,21,0
2016,7,Horta-Guinardó,33,el Baix Guinardó,70-74,16,18,-2
2016,7,Horta-Guinardó,34,Can Baró,70-74,7,4,3
2016,7,Horta-Guinardó,35,el Guinardó,70-74,13,12,1
2016,7,Horta-Guinardó,36,la Font d'en Fargues,70-74,2,4,-2
2016,7,Horta-Guinardó,37,el Carmel,70-74,10,12,-2
2016,7,Horta-Guinardó,38,la Teixonera,70-74,8,4,4
2016,7,Horta-Guinardó,39,Sant Genís dels Agudells,70-74,6,2,4
2016,7,Horta-Guinardó,40,Montbau,70-74,7,3,4
2016,7,Horta-Guinardó,41,la Vall d'Hebron,70-74,5,3,2
2016,7,Horta-Guinardó,42,la Clota,70-74,1,0,1
2016,7,Horta-Guinardó,43,Horta,70-74,5,12,-7
2016,8,Nou Barris,44,Vilapicina i la Torre Llobeta,70-74,11,13,-2
2016,8,Nou Barris,45,Porta,70-74,11,11,0
2016,8,Nou Barris,46,el Turó de la Peira,70-74,9,10,-1
2016,8,Nou Barris,47,Can Peguera,70-74,1,0,1
2016,8,Nou Barris,48,la Guineueta,70-74,8,4,4
2016,8,Nou Barris,49,Canyelles,70-74,2,2,0
2016,8,Nou Barris,50,les Roquetes,70-74,6,2,4
2016,8,Nou Barris,51,Verdun,70-74,7,5,2
2016,8,Nou Barris,52,la Prosperitat,70-74,14,15,-1
2016,8,Nou Barris,53,la Trinitat Nova,70-74,2,4,-2
2016,8,Nou Barris,54,Torre Baró,70-74,0,1,-1
2016,8,Nou Barris,55,Ciutat Meridiana,70-74,5,7,-2
2016,8,Nou Barris,56,Vallbona,70-74,1,1,0
2016,9,Sant Andreu,57,la Trinitat Vella,70-74,2,4,-2
2016,9,Sant Andreu,58,Baró de Viver,70-74,0,0,0
2016,9,Sant Andreu,59,el Bon Pastor,70-74,5,7,-2
2016,9,Sant Andreu,60,Sant Andreu,70-74,19,37,-18
2016,9,Sant Andreu,61,la Sagrera,70-74,12,10,2
2016,9,Sant Andreu,62,el Congrés i els Indians,70-74,10,8,2
2016,9,Sant Andreu,63,Navas,70-74,11,19,-8
2016,10,Sant Martí,64,el Camp de l'Arpa del Clot,70-74,16,21,-5
2016,10,Sant Martí,65,el Clot,70-74,17,16,1
2016,10,Sant Martí,66,el Parc i la Llacuna del Poblenou,70-74,3,10,-7
2016,10,Sant Martí,67,la Vila Olímpica del Poblenou,70-74,3,1,2
2016,10,Sant Martí,68,el Poblenou,70-74,11,12,-1
2016,10,Sant Martí,69,Diagonal Mar i el Front Marítim del Poblenou,70-74,9,7,2
2016,10,Sant Martí,70,el Besòs i el Maresme,70-74,11,6,5
2016,10,Sant Martí,71,Provençals del Poblenou,70-74,5,6,-1
2016,10,Sant Martí,72,Sant Martí de Provençals,70-74,14,10,4
2016,10,Sant Martí,73,la Verneda i la Pau,70-74,12,22,-10
2016,1,Ciutat Vella,1,el Raval,75-79,10,13,-3
2016,1,Ciutat Vella,2,el Barri Gòtic,75-79,5,5,0
2016,1,Ciutat Vella,3,la Barceloneta,75-79,2,6,-4
2016,1,Ciutat Vella,4,"Sant Pere, Santa Caterina i la Ribera",75-79,7,6,1
2016,2,Eixample,5,el Fort Pienc,75-79,18,12,6
2016,2,Eixample,6,la Sagrada Família,75-79,14,15,-1
2016,2,Eixample,7,la Dreta de l'Eixample,75-79,15,23,-8
2016,2,Eixample,8,l'Antiga Esquerra de l'Eixample,75-79,9,13,-4
2016,2,Eixample,9,la Nova Esquerra de l'Eixample,75-79,22,30,-8
2016,2,Eixample,10,Sant Antoni,75-79,12,14,-2
2016,3,Sants-Montjuïc,11,el Poble Sec,75-79,11,19,-8
2016,3,Sants-Montjuïc,12,la Marina del Prat Vermell,75-79,0,1,-1
2016,3,Sants-Montjuïc,13,la Marina de Port,75-79,11,10,1
2016,3,Sants-Montjuïc,14,la Font de la Guatlla,75-79,5,3,2
2016,3,Sants-Montjuïc,15,Hostafrancs,75-79,3,8,-5
2016,3,Sants-Montjuïc,16,la Bordeta,75-79,1,8,-7
2016,3,Sants-Montjuïc,17,Sants - Badal,75-79,15,14,1
2016,3,Sants-Montjuïc,18,Sants,75-79,17,19,-2
2016,4,Les Corts,19,les Corts,75-79,14,19,-5
2016,4,Les Corts,20,la Maternitat i Sant Ramon,75-79,12,14,-2
2016,4,Les Corts,21,Pedralbes,75-79,5,1,4
2016,5,Sarrià-Sant Gervasi,22,"Vallvidrera, el Tibidabo i les Planes",75-79,0,5,-5
2016,5,Sarrià-Sant Gervasi,23,Sarrià,75-79,9,12,-3
2016,5,Sarrià-Sant Gervasi,24,les Tres Torres,75-79,2,4,-2
2016,5,Sarrià-Sant Gervasi,25,Sant Gervasi - la Bonanova,75-79,14,20,-6
2016,5,Sarrià-Sant Gervasi,26,Sant Gervasi - Galvany,75-79,26,24,2
2016,5,Sarrià-Sant Gervasi,27,el Putxet i el Farró,75-79,13,11,2
2016,6,Gràcia,28,Vallcarca i els Penitents,75-79,3,7,-4
2016,6,Gràcia,29,el Coll,75-79,3,5,-2
2016,6,Gràcia,30,la Salut,75-79,11,9,2
2016,6,Gràcia,31,la Vila de Gràcia,75-79,17,19,-2
2016,6,Gràcia,32,el Camp d'en Grassot i Gràcia Nova,75-79,10,11,-1
2016,7,Horta-Guinardó,33,el Baix Guinardó,75-79,9,17,-8
2016,7,Horta-Guinardó,34,Can Baró,75-79,7,3,4
2016,7,Horta-Guinardó,35,el Guinardó,75-79,19,17,2
2016,7,Horta-Guinardó,36,la Font d'en Fargues,75-79,3,7,-4
2016,7,Horta-Guinardó,37,el Carmel,75-79,4,11,-7
2016,7,Horta-Guinardó,38,la Teixonera,75-79,6,7,-1
2016,7,Horta-Guinardó,39,Sant Genís dels Agudells,75-79,2,3,-1
2016,7,Horta-Guinardó,40,Montbau,75-79,1,1,0
2016,7,Horta-Guinardó,41,la Vall d'Hebron,75-79,4,0,4
2016,7,Horta-Guinardó,42,la Clota,75-79,0,0,0
2016,7,Horta-Guinardó,43,Horta,75-79,12,9,3
2016,8,Nou Barris,44,Vilapicina i la Torre Llobeta,75-79,12,10,2
2016,8,Nou Barris,45,Porta,75-79,12,6,6
2016,8,Nou Barris,46,el Turó de la Peira,75-79,6,4,2
2016,8,Nou Barris,47,Can Peguera,75-79,3,1,2
2016,8,Nou Barris,48,la Guineueta,75-79,5,5,0
2016,8,Nou Barris,49,Canyelles,75-79,1,5,-4
2016,8,Nou Barris,50,les Roquetes,75-79,5,8,-3
2016,8,Nou Barris,51,Verdun,75-79,6,6,0
2016,8,Nou Barris,52,la Prosperitat,75-79,8,14,-6
2016,8,Nou Barris,53,la Trinitat Nova,75-79,2,3,-1
2016,8,Nou Barris,54,Torre Baró,75-79,0,0,0
2016,8,Nou Barris,55,Ciutat Meridiana,75-79,4,10,-6
2016,8,Nou Barris,56,Vallbona,75-79,1,1,0
2016,9,Sant Andreu,57,la Trinitat Vella,75-79,3,4,-1
2016,9,Sant Andreu,58,Baró de Viver,75-79,0,2,-2
2016,9,Sant Andreu,59,el Bon Pastor,75-79,1,4,-3
2016,9,Sant Andreu,60,Sant Andreu,75-79,35,24,11
2016,9,Sant Andreu,61,la Sagrera,75-79,9,12,-3
2016,9,Sant Andreu,62,el Congrés i els Indians,75-79,6,5,1
2016,9,Sant Andreu,63,Navas,75-79,9,13,-4
2016,10,Sant Martí,64,el Camp de l'Arpa del Clot,75-79,13,14,-1
2016,10,Sant Martí,65,el Clot,75-79,10,12,-2
2016,10,Sant Martí,66,el Parc i la Llacuna del Poblenou,75-79,5,7,-2
2016,10,Sant Martí,67,la Vila Olímpica del Poblenou,75-79,2,1,1
2016,10,Sant Martí,68,el Poblenou,75-79,11,10,1
2016,10,Sant Martí,69,Diagonal Mar i el Front Marítim del Poblenou,75-79,9,5,4
2016,10,Sant Martí,70,el Besòs i el Maresme,75-79,7,13,-6
2016,10,Sant Martí,71,Provençals del Poblenou,75-79,6,9,-3
2016,10,Sant Martí,72,Sant Martí de Provençals,75-79,13,17,-4
2016,10,Sant Martí,73,la Verneda i la Pau,75-79,12,15,-3
2016,1,Ciutat Vella,1,el Raval,80-84,7,17,-10
2016,1,Ciutat Vella,2,el Barri Gòtic,80-84,3,12,-9
2016,1,Ciutat Vella,3,la Barceloneta,80-84,3,10,-7
2016,1,Ciutat Vella,4,"Sant Pere, Santa Caterina i la Ribera",80-84,3,6,-3
2016,2,Eixample,5,el Fort Pienc,80-84,10,14,-4
2016,2,Eixample,6,la Sagrada Família,80-84,9,17,-8
2016,2,Eixample,7,la Dreta de l'Eixample,80-84,27,24,3
2016,2,Eixample,8,l'Antiga Esquerra de l'Eixample,80-84,19,21,-2
2016,2,Eixample,9,la Nova Esquerra de l'Eixample,80-84,16,26,-10
2016,2,Eixample,10,Sant Antoni,80-84,9,16,-7
2016,3,Sants-Montjuïc,11,el Poble Sec,80-84,13,19,-6
2016,3,Sants-Montjuïc,12,la Marina del Prat Vermell,80-84,0,2,-2
2016,3,Sants-Montjuïc,13,la Marina de Port,80-84,12,17,-5
2016,3,Sants-Montjuïc,14,la Font de la Guatlla,80-84,5,2,3
2016,3,Sants-Montjuïc,15,Hostafrancs,80-84,2,5,-3
2016,3,Sants-Montjuïc,16,la Bordeta,80-84,4,16,-12
2016,3,Sants-Montjuïc,17,Sants - Badal,80-84,3,13,-10
2016,3,Sants-Montjuïc,18,Sants,80-84,10,15,-5
2016,4,Les Corts,19,les Corts,80-84,23,18,5
2016,4,Les Corts,20,la Maternitat i Sant Ramon,80-84,9,11,-2
2016,4,Les Corts,21,Pedralbes,80-84,6,3,3
2016,5,Sarrià-Sant Gervasi,22,"Vallvidrera, el Tibidabo i les Planes",80-84,0,2,-2
2016,5,Sarrià-Sant Gervasi,23,Sarrià,80-84,6,13,-7
2016,5,Sarrià-Sant Gervasi,24,les Tres Torres,80-84,4,4,0
2016,5,Sarrià-Sant Gervasi,25,Sant Gervasi - la Bonanova,80-84,17,17,0
2016,5,Sarrià-Sant Gervasi,26,Sant Gervasi - Galvany,80-84,18,15,3
2016,5,Sarrià-Sant Gervasi,27,el Putxet i el Farró,80-84,8,16,-8
2016,6,Gràcia,28,Vallcarca i els Penitents,80-84,5,2,3
2016,6,Gràcia,29,el Coll,80-84,2,2,0
2016,6,Gràcia,30,la Salut,80-84,10,12,-2
2016,6,Gràcia,31,la Vila de Gràcia,80-84,21,23,-2
2016,6,Gràcia,32,el Camp d'en Grassot i Gràcia Nova,80-84,11,12,-1
2016,7,Horta-Guinardó,33,el Baix Guinardó,80-84,14,11,3
2016,7,Horta-Guinardó,34,Can Baró,80-84,2,6,-4
2016,7,Horta-Guinardó,35,el Guinardó,80-84,13,15,-2
2016,7,Horta-Guinardó,36,la Font d'en Fargues,80-84,3,4,-1
2016,7,Horta-Guinardó,37,el Carmel,80-84,5,24,-19
2016,7,Horta-Guinardó,38,la Teixonera,80-84,3,5,-2
2016,7,Horta-Guinardó,39,Sant Genís dels Agudells,80-84,6,9,-3
2016,7,Horta-Guinardó,40,Montbau,80-84,3,5,-2
2016,7,Horta-Guinardó,41,la Vall d'Hebron,80-84,2,3,-1
2016,7,Horta-Guinardó,42,la Clota,80-84,0,0,0
2016,7,Horta-Guinardó,43,Horta,80-84,7,20,-13
2016,8,Nou Barris,44,Vilapicina i la Torre Llobeta,80-84,5,14,-9
2016,8,Nou Barris,45,Porta,80-84,3,12,-9
2016,8,Nou Barris,46,el Turó de la Peira,80-84,2,14,-12
2016,8,Nou Barris,47,Can Peguera,80-84,1,0,1
2016,8,Nou Barris,48,la Guineueta,80-84,3,7,-4
2016,8,Nou Barris,49,Canyelles,80-84,2,6,-4
2016,8,Nou Barris,50,les Roquetes,80-84,4,8,-4
2016,8,Nou Barris,51,Verdun,80-84,2,5,-3
2016,8,Nou Barris,52,la Prosperitat,80-84,8,25,-17
2016,8,Nou Barris,53,la Trinitat Nova,80-84,2,2,0
2016,8,Nou Barris,54,Torre Baró,80-84,0,1,-1
2016,8,Nou Barris,55,Ciutat Meridiana,80-84,2,3,-1
2016,8,Nou Barris,56,Vallbona,80-84,2,1,1
2016,9,Sant Andreu,57,la Trinitat Vella,80-84,3,2,1
2016,9,Sant Andreu,58,Baró de Viver,80-84,0,1,-1
2016,9,Sant Andreu,59,el Bon Pastor,80-84,6,3,3
2016,9,Sant Andreu,60,Sant Andreu,80-84,21,24,-3
2016,9,Sant Andreu,61,la Sagrera,80-84,6,7,-1
2016,9,Sant Andreu,62,el Congrés i els Indians,80-84,5,8,-3
2016,9,Sant Andreu,63,Navas,80-84,4,9,-5
2016,10,Sant Martí,64,el Camp de l'Arpa del Clot,80-84,8,15,-7
2016,10,Sant Martí,65,el Clot,80-84,4,5,-1
2016,10,Sant Martí,66,el Parc i la Llacuna del Poblenou,80-84,4,11,-7
2016,10,Sant Martí,67,la Vila Olímpica del Poblenou,80-84,4,4,0
2016,10,Sant Martí,68,el Poblenou,80-84,3,17,-14
2016,10,Sant Martí,69,Diagonal Mar i el Front Marítim del Poblenou,80-84,2,9,-7
2016,10,Sant Martí,70,el Besòs i el Maresme,80-84,4,20,-16
2016,10,Sant Martí,71,Provençals del Poblenou,80-84,4,18,-14
2016,10,Sant Martí,72,Sant Martí de Provençals,80-84,15,23,-8
2016,10,Sant Martí,73,la Verneda i la Pau,80-84,7,18,-11
2016,1,Ciutat Vella,1,el Raval,85-89,1,24,-23
2016,1,Ciutat Vella,2,el Barri Gòtic,85-89,2,6,-4
2016,1,Ciutat Vella,3,la Barceloneta,85-89,2,6,-4
2016,1,Ciutat Vella,4,"Sant Pere, Santa Caterina i la Ribera",85-89,1,13,-12
2016,2,Eixample,5,el Fort Pienc,85-89,5,14,-9
2016,2,Eixample,6,la Sagrada Família,85-89,23,28,-5
2016,2,Eixample,7,la Dreta de l'Eixample,85-89,18,28,-10
2016,2,Eixample,8,l'Antiga Esquerra de l'Eixample,85-89,8,21,-13
2016,2,Eixample,9,la Nova Esquerra de l'Eixample,85-89,18,22,-4
2016,2,Eixample,10,Sant Antoni,85-89,6,25,-19
2016,3,Sants-Montjuïc,11,el Poble Sec,85-89,8,23,-15
2016,3,Sants-Montjuïc,12,la Marina del Prat Vermell,85-89,0,1,-1
2016,3,Sants-Montjuïc,13,la Marina de Port,85-89,9,16,-7
2016,3,Sants-Montjuïc,14,la Font de la Guatlla,85-89,3,3,0
2016,3,Sants-Montjuïc,15,Hostafrancs,85-89,2,5,-3
2016,3,Sants-Montjuïc,16,la Bordeta,85-89,1,10,-9
2016,3,Sants-Montjuïc,17,Sants - Badal,85-89,13,18,-5
2016,3,Sants-Montjuïc,18,Sants,85-89,10,30,-20
2016,4,Les Corts,19,les Corts,85-89,13,21,-8
2016,4,Les Corts,20,la Maternitat i Sant Ramon,85-89,11,15,-4
2016,4,Les Corts,21,Pedralbes,85-89,2,5,-3
2016,5,Sarrià-Sant Gervasi,22,"Vallvidrera, el Tibidabo i les Planes",85-89,0,2,-2
2016,5,Sarrià-Sant Gervasi,23,Sarrià,85-89,11,16,-5
2016,5,Sarrià-Sant Gervasi,24,les Tres Torres,85-89,1,1,0
2016,5,Sarrià-Sant Gervasi,25,Sant Gervasi - la Bonanova,85-89,15,16,-1
2016,5,Sarrià-Sant Gervasi,26,Sant Gervasi - Galvany,85-89,8,17,-9
2016,5,Sarrià-Sant Gervasi,27,el Putxet i el Farró,85-89,9,12,-3
2016,6,Gràcia,28,Vallcarca i els Penitents,85-89,3,8,-5
2016,6,Gràcia,29,el Coll,85-89,0,4,-4
2016,6,Gràcia,30,la Salut,85-89,5,3,2
2016,6,Gràcia,31,la Vila de Gràcia,85-89,7,22,-15
2016,6,Gràcia,32,el Camp d'en Grassot i Gràcia Nova,85-89,5,20,-15
2016,7,Horta-Guinardó,33,el Baix Guinardó,85-89,13,13,0
2016,7,Horta-Guinardó,34,Can Baró,85-89,1,6,-5
2016,7,Horta-Guinardó,35,el Guinardó,85-89,6,30,-24
2016,7,Horta-Guinardó,36,la Font d'en Fargues,85-89,6,3,3
2016,7,Horta-Guinardó,37,el Carmel,85-89,7,10,-3
2016,7,Horta-Guinardó,38,la Teixonera,85-89,2,3,-1
2016,7,Horta-Guinardó,39,Sant Genís dels Agudells,85-89,2,2,0
2016,7,Horta-Guinardó,40,Montbau,85-89,4,2,2
2016,7,Horta-Guinardó,41,la Vall d'Hebron,85-89,0,2,-2
2016,7,Horta-Guinardó,42,la Clota,85-89,0,0,0
2016,7,Horta-Guinardó,43,Horta,85-89,6,9,-3
2016,8,Nou Barris,44,Vilapicina i la Torre Llobeta,85-89,6,11,-5
2016,8,Nou Barris,45,Porta,85-89,4,16,-12
2016,8,Nou Barris,46,el Turó de la Peira,85-89,1,17,-16
2016,8,Nou Barris,47,Can Peguera,85-89,0,3,-3
2016,8,Nou Barris,48,la Guineueta,85-89,4,6,-2
2016,8,Nou Barris,49,Canyelles,85-89,1,1,0
2016,8,Nou Barris,50,les Roquetes,85-89,1,6,-5
2016,8,Nou Barris,51,Verdun,85-89,2,6,-4
2016,8,Nou Barris,52,la Prosperitat,85-89,9,13,-4
2016,8,Nou Barris,53,la Trinitat Nova,85-89,0,9,-9
2016,8,Nou Barris,54,Torre Baró,85-89,0,3,-3
2016,8,Nou Barris,55,Ciutat Meridiana,85-89,1,2,-1
2016,8,Nou Barris,56,Vallbona,85-89,1,0,1
2016,9,Sant Andreu,57,la Trinitat Vella,85-89,0,4,-4
2016,9,Sant Andreu,58,Baró de Viver,85-89,0,0,0
2016,9,Sant Andreu,59,el Bon Pastor,85-89,0,5,-5
2016,9,Sant Andreu,60,Sant Andreu,85-89,7,30,-23
2016,9,Sant Andreu,61,la Sagrera,85-89,10,12,-2
2016,9,Sant Andreu,62,el Congrés i els Indians,85-89,0,10,-10
2016,9,Sant Andreu,63,Navas,85-89,2,10,-8
2016,10,Sant Martí,64,el Camp de l'Arpa del Clot,85-89,5,15,-10
2016,10,Sant Martí,65,el Clot,85-89,9,11,-2
2016,10,Sant Martí,66,el Parc i la Llacuna del Poblenou,85-89,4,5,-1
2016,10,Sant Martí,67,la Vila Olímpica del Poblenou,85-89,3,0,3
2016,10,Sant Martí,68,el Poblenou,85-89,6,15,-9
2016,10,Sant Martí,69,Diagonal Mar i el Front Marítim del Poblenou,85-89,4,6,-2
2016,10,Sant Martí,70,el Besòs i el Maresme,85-89,2,12,-10
2016,10,Sant Martí,71,Provençals del Poblenou,85-89,5,13,-8
2016,10,Sant Martí,72,Sant Martí de Provençals,85-89,9,19,-10
2016,10,Sant Martí,73,la Verneda i la Pau,85-89,4,21,-17
2016,1,Ciutat Vella,1,el Raval,90-94,1,13,-12
2016,1,Ciutat Vella,2,el Barri Gòtic,90-94,1,1,0
2016,1,Ciutat Vella,3,la Barceloneta,90-94,0,4,-4
2016,1,Ciutat Vella,4,"Sant Pere, Santa Caterina i la Ribera",90-94,2,7,-5
2016,2,Eixample,5,el Fort Pienc,90-94,5,9,-4
2016,2,Eixample,6,la Sagrada Família,90-94,10,25,-15
2016,2,Eixample,7,la Dreta de l'Eixample,90-94,10,15,-5
2016,2,Eixample,8,l'Antiga Esquerra de l'Eixample,90-94,5,11,-6
2016,2,Eixample,9,la Nova Esquerra de l'Eixample,90-94,5,19,-14
2016,2,Eixample,10,Sant Antoni,90-94,1,12,-11
2016,3,Sants-Montjuïc,11,el Poble Sec,90-94,0,9,-9
2016,3,Sants-Montjuïc,12,la Marina del Prat Vermell,90-94,0,0,0
2016,3,Sants-Montjuïc,13,la Marina de Port,90-94,6,6,0
2016,3,Sants-Montjuïc,14,la Font de la Guatlla,90-94,1,4,-3
2016,3,Sants-Montjuïc,15,Hostafrancs,90-94,1,3,-2
2016,3,Sants-Montjuïc,16,la Bordeta,90-94,1,3,-2
2016,3,Sants-Montjuïc,17,Sants - Badal,90-94,6,6,0
2016,3,Sants-Montjuïc,18,Sants,90-94,4,10,-6
2016,4,Les Corts,19,les Corts,90-94,7,15,-8
2016,4,Les Corts,20,la Maternitat i Sant Ramon,90-94,2,9,-7
2016,4,Les Corts,21,Pedralbes,90-94,0,0,0
2016,5,Sarrià-Sant Gervasi,22,"Vallvidrera, el Tibidabo i les Planes",90-94,0,0,0
2016,5,Sarrià-Sant Gervasi,23,Sarrià,90-94,6,5,1
2016,5,Sarrià-Sant Gervasi,24,les Tres Torres,90-94,3,4,-1
2016,5,Sarrià-Sant Gervasi,25,Sant Gervasi - la Bonanova,90-94,8,16,-8
2016,5,Sarrià-Sant Gervasi,26,Sant Gervasi - Galvany,90-94,8,15,-7
2016,5,Sarrià-Sant Gervasi,27,el Putxet i el Farró,90-94,2,5,-3
2016,6,Gràcia,28,Vallcarca i els Penitents,90-94,2,6,-4
2016,6,Gràcia,29,el Coll,90-94,0,2,-2
2016,6,Gràcia,30,la Salut,90-94,3,0,3
2016,6,Gràcia,31,la Vila de Gràcia,90-94,4,11,-7
2016,6,Gràcia,32,el Camp d'en Grassot i Gràcia Nova,90-94,5,12,-7
2016,7,Horta-Guinardó,33,el Baix Guinardó,90-94,4,6,-2
2016,7,Horta-Guinardó,34,Can Baró,90-94,1,2,-1
2016,7,Horta-Guinardó,35,el Guinardó,90-94,4,13,-9
2016,7,Horta-Guinardó,36,la Font d'en Fargues,90-94,1,1,0
2016,7,Horta-Guinardó,37,el Carmel,90-94,3,9,-6
2016,7,Horta-Guinardó,38,la Teixonera,90-94,3,2,1
2016,7,Horta-Guinardó,39,Sant Genís dels Agudells,90-94,0,0,0
2016,7,Horta-Guinardó,40,Montbau,90-94,2,3,-1
2016,7,Horta-Guinardó,41,la Vall d'Hebron,90-94,3,2,1
2016,7,Horta-Guinardó,42,la Clota,90-94,0,0,0
2016,7,Horta-Guinardó,43,Horta,90-94,3,7,-4
2016,8,Nou Barris,44,Vilapicina i la Torre Llobeta,90-94,7,8,-1
2016,8,Nou Barris,45,Porta,90-94,3,8,-5
2016,8,Nou Barris,46,el Turó de la Peira,90-94,0,10,-10
2016,8,Nou Barris,47,Can Peguera,90-94,0,2,-2
2016,8,Nou Barris,48,la Guineueta,90-94,3,5,-2
2016,8,Nou Barris,49,Canyelles,90-94,0,3,-3
2016,8,Nou Barris,50,les Roquetes,90-94,0,3,-3
2016,8,Nou Barris,51,Verdun,90-94,1,4,-3
2016,8,Nou Barris,52,la Prosperitat,90-94,1,5,-4
2016,8,Nou Barris,53,la Trinitat Nova,90-94,0,0,0
2016,8,Nou Barris,54,Torre Baró,90-94,0,2,-2
2016,8,Nou Barris,55,Ciutat Meridiana,90-94,0,1,-1
2016,8,Nou Barris,56,Vallbona,90-94,0,0,0
2016,9,Sant Andreu,57,la Trinitat Vella,90-94,1,0,1
2016,9,Sant Andreu,58,Baró de Viver,90-94,0,2,-2
2016,9,Sant Andreu,59,el Bon Pastor,90-94,0,3,-3
2016,9,Sant Andreu,60,Sant Andreu,90-94,7,12,-5
2016,9,Sant Andreu,61,la Sagrera,90-94,2,9,-7
2016,9,Sant Andreu,62,el Congrés i els Indians,90-94,0,8,-8
2016,9,Sant Andreu,63,Navas,90-94,1,9,-8
2016,10,Sant Martí,64,el Camp de l'Arpa del Clot,90-94,3,13,-10
2016,10,Sant Martí,65,el Clot,90-94,5,8,-3
2016,10,Sant Martí,66,el Parc i la Llacuna del Poblenou,90-94,0,2,-2
2016,10,Sant Martí,67,la Vila Olímpica del Poblenou,90-94,1,2,-1
2016,10,Sant Martí,68,el Poblenou,90-94,4,3,1
2016,10,Sant Martí,69,Diagonal Mar i el Front Marítim del Poblenou,90-94,0,2,-2
2016,10,Sant Martí,70,el Besòs i el Maresme,90-94,0,2,-2
2016,10,Sant Martí,71,Provençals del Poblenou,90-94,1,6,-5
2016,10,Sant Martí,72,Sant Martí de Provençals,90-94,2,8,-6
2016,10,Sant Martí,73,la Verneda i la Pau,90-94,2,12,-10
2016,1,Ciutat Vella,1,el Raval,95-99,2,2,0
2016,1,Ciutat Vella,2,el Barri Gòtic,95-99,0,0,0
2016,1,Ciutat Vella,3,la Barceloneta,95-99,1,1,0
2016,1,Ciutat Vella,4,"Sant Pere, Santa Caterina i la Ribera",95-99,0,2,-2
2016,2,Eixample,5,el Fort Pienc,95-99,1,7,-6
2016,2,Eixample,6,la Sagrada Família,95-99,1,1,0
2016,2,Eixample,7,la Dreta de l'Eixample,95-99,1,2,-1
2016,2,Eixample,8,l'Antiga Esquerra de l'Eixample,95-99,1,3,-2
2016,2,Eixample,9,la Nova Esquerra de l'Eixample,95-99,2,5,-3
2016,2,Eixample,10,Sant Antoni,95-99,1,4,-3
2016,3,Sants-Montjuïc,11,el Poble Sec,95-99,0,1,-1
2016,3,Sants-Montjuïc,12,la Marina del Prat Vermell,95-99,0,0,0
2016,3,Sants-Montjuïc,13,la Marina de Port,95-99,1,1,0
2016,3,Sants-Montjuïc,14,la Font de la Guatlla,95-99,0,2,-2
2016,3,Sants-Montjuïc,15,Hostafrancs,95-99,1,1,0
2016,3,Sants-Montjuïc,16,la Bordeta,95-99,1,0,1
2016,3,Sants-Montjuïc,17,Sants - Badal,95-99,0,4,-4
2016,3,Sants-Montjuïc,18,Sants,95-99,0,1,-1
2016,4,Les Corts,19,les Corts,95-99,1,5,-4
2016,4,Les Corts,20,la Maternitat i Sant Ramon,95-99,0,4,-4
2016,4,Les Corts,21,Pedralbes,95-99,1,0,1
2016,5,Sarrià-Sant Gervasi,22,"Vallvidrera, el Tibidabo i les Planes",95-99,0,0,0
2016,5,Sarrià-Sant Gervasi,23,Sarrià,95-99,1,3,-2
2016,5,Sarrià-Sant Gervasi,24,les Tres Torres,95-99,0,1,-1
2016,5,Sarrià-Sant Gervasi,25,Sant Gervasi - la Bonanova,95-99,2,3,-1
2016,5,Sarrià-Sant Gervasi,26,Sant Gervasi - Galvany,95-99,1,1,0
2016,5,Sarrià-Sant Gervasi,27,el Putxet i el Farró,95-99,1,3,-2
2016,6,Gràcia,28,Vallcarca i els Penitents,95-99,2,2,0
2016,6,Gràcia,29,el Coll,95-99,0,1,-1
2016,6,Gràcia,30,la Salut,95-99,0,3,-3
2016,6,Gràcia,31,la Vila de Gràcia,95-99,0,3,-3
2016,6,Gràcia,32,el Camp d'en Grassot i Gràcia Nova,95-99,1,2,-1
2016,7,Horta-Guinardó,33,el Baix Guinardó,95-99,3,1,2
2016,7,Horta-Guinardó,34,Can Baró,95-99,0,1,-1
2016,7,Horta-Guinardó,35,el Guinardó,95-99,1,1,0
2016,7,Horta-Guinardó,36,la Font d'en Fargues,95-99,0,0,0
2016,7,Horta-Guinardó,37,el Carmel,95-99,1,1,0
2016,7,Horta-Guinardó,38,la Teixonera,95-99,0,1,-1
2016,7,Horta-Guinardó,39,Sant Genís dels Agudells,95-99,1,0,1
2016,7,Horta-Guinardó,40,Montbau,95-99,0,0,0
2016,7,Horta-Guinardó,41,la Vall d'Hebron,95-99,0,0,0
2016,7,Horta-Guinardó,42,la Clota,95-99,0,0,0
2016,7,Horta-Guinardó,43,Horta,95-99,0,1,-1
2016,8,Nou Barris,44,Vilapicina i la Torre Llobeta,95-99,0,1,-1
2016,8,Nou Barris,45,Porta,95-99,0,2,-2
2016,8,Nou Barris,46,el Turó de la Peira,95-99,0,2,-2
2016,8,Nou Barris,47,Can Peguera,95-99,0,1,-1
2016,8,Nou Barris,48,la Guineueta,95-99,0,0,0
2016,8,Nou Barris,49,Canyelles,95-99,0,0,0
2016,8,Nou Barris,50,les Roquetes,95-99,1,0,1
2016,8,Nou Barris,51,Verdun,95-99,1,0,1
2016,8,Nou Barris,52,la Prosperitat,95-99,1,1,0
2016,8,Nou Barris,53,la Trinitat Nova,95-99,0,0,0
2016,8,Nou Barris,54,Torre Baró,95-99,0,0,0
2016,8,Nou Barris,55,Ciutat Meridiana,95-99,1,1,0
2016,8,Nou Barris,56,Vallbona,95-99,2,0,2
2016,9,Sant Andreu,57,la Trinitat Vella,95-99,0,0,0
2016,9,Sant Andreu,58,Baró de Viver,95-99,0,0,0
2016,9,Sant Andreu,59,el Bon Pastor,95-99,0,1,-1
2016,9,Sant Andreu,60,Sant Andreu,95-99,3,1,2
2016,9,Sant Andreu,61,la Sagrera,95-99,0,3,-3
2016,9,Sant Andreu,62,el Congrés i els Indians,95-99,0,1,-1
2016,9,Sant Andreu,63,Navas,95-99,0,1,-1
2016,10,Sant Martí,64,el Camp de l'Arpa del Clot,95-99,2,1,1
2016,10,Sant Martí,65,el Clot,95-99,1,2,-1
2016,10,Sant Martí,66,el Parc i la Llacuna del Poblenou,95-99,0,0,0
2016,10,Sant Martí,67,la Vila Olímpica del Poblenou,95-99,0,0,0
2016,10,Sant Martí,68,el Poblenou,95-99,1,3,-2
2016,10,Sant Martí,69,Diagonal Mar i el Front Marítim del Poblenou,95-99,0,0,0
2016,10,Sant Martí,70,el Besòs i el Maresme,95-99,2,1,1
2016,10,Sant Martí,71,Provençals del Poblenou,95-99,1,0,1
2016,10,Sant Martí,72,Sant Martí de Provençals,95-99,0,2,-2
2016,10,Sant Martí,73,la Verneda i la Pau,95-99,1,0,1
2016,1,Ciutat Vella,1,el Raval,>=100,0,0,0
2016,1,Ciutat Vella,2,el Barri Gòtic,>=100,0,0,0
2016,1,Ciutat Vella,3,la Barceloneta,>=100,0,0,0
2016,1,Ciutat Vella,4,"Sant Pere, Santa Caterina i la Ribera",>=100,0,0,0
2016,2,Eixample,5,el Fort Pienc,>=100,0,0,0
2016,2,Eixample,6,la Sagrada Família,>=100,1,1,0
2016,2,Eixample,7,la Dreta de l'Eixample,>=100,0,0,0
2016,2,Eixample,8,l'Antiga Esquerra de l'Eixample,>=100,0,1,-1
2016,2,Eixample,9,la Nova Esquerra de l'Eixample,>=100,0,2,-2
2016,2,Eixample,10,Sant Antoni,>=100,1,0,1
2016,3,Sants-Montjuïc,11,el Poble Sec,>=100,0,0,0
2016,3,Sants-Montjuïc,12,la Marina del Prat Vermell,>=100,0,0,0
2016,3,Sants-Montjuïc,13,la Marina de Port,>=100,0,0,0
2016,3,Sants-Montjuïc,14,la Font de la Guatlla,>=100,0,0,0
2016,3,Sants-Montjuïc,15,Hostafrancs,>=100,0,0,0
2016,3,Sants-Montjuïc,16,la Bordeta,>=100,0,0,0
2016,3,Sants-Montjuïc,17,Sants - Badal,>=100,0,0,0
2016,3,Sants-Montjuïc,18,Sants,>=100,0,0,0
2016,4,Les Corts,19,les Corts,>=100,1,0,1
2016,4,Les Corts,20,la Maternitat i Sant Ramon,>=100,0,0,0
2016,4,Les Corts,21,Pedralbes,>=100,0,0,0
2016,5,Sarrià-Sant Gervasi,22,"Vallvidrera, el Tibidabo i les Planes",>=100,0,1,-1
2016,5,Sarrià-Sant Gervasi,23,Sarrià,>=100,0,0,0
2016,5,Sarrià-Sant Gervasi,24,les Tres Torres,>=100,0,0,0
2016,5,Sarrià-Sant Gervasi,25,Sant Gervasi - la Bonanova,>=100,0,1,-1
2016,5,Sarrià-Sant Gervasi,26,Sant Gervasi - Galvany,>=100,0,0,0
2016,5,Sarrià-Sant Gervasi,27,el Putxet i el Farró,>=100,0,0,0
2016,6,Gràcia,28,Vallcarca i els Penitents,>=100,0,0,0
2016,6,Gràcia,29,el Coll,>=100,0,0,0
2016,6,Gràcia,30,la Salut,>=100,0,0,0
2016,6,Gràcia,31,la Vila de Gràcia,>=100,0,0,0
2016,6,Gràcia,32,el Camp d'en Grassot i Gràcia Nova,>=100,1,0,1
2016,7,Horta-Guinardó,33,el Baix Guinardó,>=100,0,0,0
2016,7,Horta-Guinardó,34,Can Baró,>=100,0,0,0
2016,7,Horta-Guinardó,35,el Guinardó,>=100,0,0,0
2016,7,Horta-Guinardó,36,la Font d'en Fargues,>=100,0,0,0
2016,7,Horta-Guinardó,37,el Carmel,>=100,0,1,-1
2016,7,Horta-Guinardó,38,la Teixonera,>=100,0,0,0
2016,7,Horta-Guinardó,39,Sant Genís dels Agudells,>=100,0,0,0
2016,7,Horta-Guinardó,40,Montbau,>=100,0,0,0
2016,7,Horta-Guinardó,41,la Vall d'Hebron,>=100,0,0,0
2016,7,Horta-Guinardó,42,la Clota,>=100,0,0,0
2016,7,Horta-Guinardó,43,Horta,>=100,0,0,0
2016,8,Nou Barris,44,Vilapicina i la Torre Llobeta,>=100,0,0,0
2016,8,Nou Barris,45,Porta,>=100,0,0,0
2016,8,Nou Barris,46,el Turó de la Peira,>=100,0,0,0
2016,8,Nou Barris,47,Can Peguera,>=100,0,0,0
2016,8,Nou Barris,48,la Guineueta,>=100,0,0,0
2016,8,Nou Barris,49,Canyelles,>=100,0,0,0
2016,8,Nou Barris,50,les Roquetes,>=100,0,0,0
2016,8,Nou Barris,51,Verdun,>=100,0,0,0
2016,8,Nou Barris,52,la Prosperitat,>=100,0,0,0
2016,8,Nou Barris,53,la Trinitat Nova,>=100,0,0,0
2016,8,Nou Barris,54,Torre Baró,>=100,0,0,0
2016,8,Nou Barris,55,Ciutat Meridiana,>=100,0,0,0
2016,8,Nou Barris,56,Vallbona,>=100,0,0,0
2016,9,Sant Andreu,57,la Trinitat Vella,>=100,0,0,0
2016,9,Sant Andreu,58,Baró de Viver,>=100,0,0,0
2016,9,Sant Andreu,59,el Bon Pastor,>=100,0,0,0
2016,9,Sant Andreu,60,Sant Andreu,>=100,1,0,1
2016,9,Sant Andreu,61,la Sagrera,>=100,0,0,0
2016,9,Sant Andreu,62,el Congrés i els Indians,>=100,0,0,0
2016,9,Sant Andreu,63,Navas,>=100,0,1,-1
2016,10,Sant Martí,64,el Camp de l'Arpa del Clot,>=100,0,0,0
2016,10,Sant Martí,65,el Clot,>=100,1,0,1
2016,10,Sant Martí,66,el Parc i la Llacuna del Poblenou,>=100,0,0,0
2016,10,Sant Martí,67,la Vila Olímpica del Poblenou,>=100,0,0,0
2016,10,Sant Martí,68,el Poblenou,>=100,0,0,0
2016,10,Sant Martí,69,Diagonal Mar i el Front Marítim del Poblenou,>=100,0,0,0
2016,10,Sant Martí,70,el Besòs i el Maresme,>=100,0,0,0
2016,10,Sant Martí,71,Provençals del Poblenou,>=100,0,0,0
2016,10,Sant Martí,72,Sant Martí de Provençals,>=100,0,0,0
2016,10,Sant Martí,73,la Verneda i la Pau,>=100,0,0,0
2015,1,Ciutat Vella,1,el Raval,0-4,165,112,53
2015,1,Ciutat Vella,2,el Barri Gòtic,0-4,49,28,21
2015,1,Ciutat Vella,3,la Barceloneta,0-4,36,21,15
2015,1,Ciutat Vella,4,"Sant Pere, Santa Caterina i la Ribera",0-4,64,35,29
2015,2,Eixample,5,el Fort Pienc,0-4,78,62,16
2015,2,Eixample,6,la Sagrada Família,0-4,101,80,21
2015,2,Eixample,7,la Dreta de l'Eixample,0-4,94,75,19
2015,2,Eixample,8,l'Antiga Esquerra de l'Eixample,0-4,73,47,26
2015,2,Eixample,9,la Nova Esquerra de l'Eixample,0-4,111,96,15
2015,2,Eixample,10,Sant Antoni,0-4,68,58,10
2015,3,Sants-Montjuïc,11,el Poble Sec,0-4,81,94,-13
2015,3,Sants-Montjuïc,12,la Marina del Prat Vermell,0-4,6,5,1
2015,3,Sants-Montjuïc,13,la Marina de Port,0-4,64,72,-8
2015,3,Sants-Montjuïc,14,la Font de la Guatlla,0-4,33,29,4
2015,3,Sants-Montjuïc,15,Hostafrancs,0-4,36,29,7
2015,3,Sants-Montjuïc,16,la Bordeta,0-4,46,42,4
2015,3,Sants-Montjuïc,17,Sants - Badal,0-4,39,58,-19
2015,3,Sants-Montjuïc,18,Sants,0-4,79,92,-13
2015,4,Les Corts,19,les Corts,0-4,113,79,34
2015,4,Les Corts,20,la Maternitat i Sant Ramon,0-4,84,51,33
2015,4,Les Corts,21,Pedralbes,0-4,53,18,35
2015,5,Sarrià-Sant Gervasi,22,"Vallvidrera, el Tibidabo i les Planes",0-4,20,16,4
2015,5,Sarrià-Sant Gervasi,23,Sarrià,0-4,81,50,31
2015,5,Sarrià-Sant Gervasi,24,les Tres Torres,0-4,51,22,29
2015,5,Sarrià-Sant Gervasi,25,Sant Gervasi - la Bonanova,0-4,72,34,38
2015,5,Sarrià-Sant Gervasi,26,Sant Gervasi - Galvany,0-4,96,77,19
2015,5,Sarrià-Sant Gervasi,27,el Putxet i el Farró,0-4,67,50,17
2015,6,Gràcia,28,Vallcarca i els Penitents,0-4,25,29,-4
2015,6,Gràcia,29,el Coll,0-4,21,18,3
2015,6,Gràcia,30,la Salut,0-4,21,21,0
2015,6,Gràcia,31,la Vila de Gràcia,0-4,93,66,27
2015,6,Gràcia,32,el Camp d'en Grassot i Gràcia Nova,0-4,53,52,1
2015,7,Horta-Guinardó,33,el Baix Guinardó,0-4,46,40,6
2015,7,Horta-Guinardó,34,Can Baró,0-4,10,11,-1
2015,7,Horta-Guinardó,35,el Guinardó,0-4,55,61,-6
2015,7,Horta-Guinardó,36,la Font d'en Fargues,0-4,14,5,9
2015,7,Horta-Guinardó,37,el Carmel,0-4,55,56,-1
2015,7,Horta-Guinardó,38,la Teixonera,0-4,24,18,6
2015,7,Horta-Guinardó,39,Sant Genís dels Agudells,0-4,12,6,6
2015,7,Horta-Guinardó,40,Montbau,0-4,10,5,5
2015,7,Horta-Guinardó,41,la Vall d'Hebron,0-4,10,4,6
2015,7,Horta-Guinardó,42,la Clota,0-4,2,0,2
2015,7,Horta-Guinardó,43,Horta,0-4,42,25,17
2015,8,Nou Barris,44,Vilapicina i la Torre Llobeta,0-4,40,32,8
2015,8,Nou Barris,45,Porta,0-4,40,31,9
2015,8,Nou Barris,46,el Turó de la Peira,0-4,31,32,-1
2015,8,Nou Barris,47,Can Peguera,0-4,2,1,1
2015,8,Nou Barris,48,la Guineueta,0-4,19,32,-13
2015,8,Nou Barris,49,Canyelles,0-4,11,13,-2
2015,8,Nou Barris,50,les Roquetes,0-4,36,37,-1
2015,8,Nou Barris,51,Verdun,0-4,22,18,4
2015,8,Nou Barris,52,la Prosperitat,0-4,53,28,25
2015,8,Nou Barris,53,la Trinitat Nova,0-4,25,17,8
2015,8,Nou Barris,54,Torre Baró,0-4,15,5,10
2015,8,Nou Barris,55,Ciutat Meridiana,0-4,26,27,-1
2015,8,Nou Barris,56,Vallbona,0-4,8,2,6
2015,9,Sant Andreu,57,la Trinitat Vella,0-4,39,30,9
2015,9,Sant Andreu,58,Baró de Viver,0-4,15,4,11
2015,9,Sant Andreu,59,el Bon Pastor,0-4,36,27,9
2015,9,Sant Andreu,60,Sant Andreu,0-4,84,90,-6
2015,9,Sant Andreu,61,la Sagrera,0-4,46,38,8
2015,9,Sant Andreu,62,el Congrés i els Indians,0-4,27,19,8
2015,9,Sant Andreu,63,Navas,0-4,51,42,9
2015,10,Sant Martí,64,el Camp de l'Arpa del Clot,0-4,69,75,-6
2015,10,Sant Martí,65,el Clot,0-4,45,32,13
2015,10,Sant Martí,66,el Parc i la Llacuna del Poblenou,0-4,30,24,6
2015,10,Sant Martí,67,la Vila Olímpica del Poblenou,0-4,41,20,21
2015,10,Sant Martí,68,el Poblenou,0-4,88,69,19
2015,10,Sant Martí,69,Diagonal Mar i el Front Marítim del Poblenou,0-4,61,42,19
2015,10,Sant Martí,70,el Besòs i el Maresme,0-4,101,83,18
2015,10,Sant Martí,71,Provençals del Poblenou,0-4,52,29,23
2015,10,Sant Martí,72,Sant Martí de Provençals,0-4,41,27,14
2015,10,Sant Martí,73,la Verneda i la Pau,0-4,51,55,-4
2015,1,Ciutat Vella,1,el Raval,5-9,149,100,49
2015,1,Ciutat Vella,2,el Barri Gòtic,5-9,35,25,10
2015,1,Ciutat Vella,3,la Barceloneta,5-9,15,17,-2
2015,1,Ciutat Vella,4,"Sant Pere, Santa Caterina i la Ribera",5-9,41,38,3
2015,2,Eixample,5,el Fort Pienc,5-9,56,39,17
2015,2,Eixample,6,la Sagrada Família,5-9,62,44,18
2015,2,Eixample,7,la Dreta de l'Eixample,5-9,67,47,20
2015,2,Eixample,8,l'Antiga Esquerra de l'Eixample,5-9,68,38,30
2015,2,Eixample,9,la Nova Esquerra de l'Eixample,5-9,75,61,14
2015,2,Eixample,10,Sant Antoni,5-9,57,45,12
2015,3,Sants-Montjuïc,11,el Poble Sec,5-9,66,59,7
2015,3,Sants-Montjuïc,12,la Marina del Prat Vermell,5-9,5,1,4
2015,3,Sants-Montjuïc,13,la Marina de Port,5-9,52,51,1
2015,3,Sants-Montjuïc,14,la Font de la Guatlla,5-9,15,22,-7
2015,3,Sants-Montjuïc,15,Hostafrancs,5-9,34,21,13
2015,3,Sants-Montjuïc,16,la Bordeta,5-9,32,28,4
2015,3,Sants-Montjuïc,17,Sants - Badal,5-9,46,41,5
2015,3,Sants-Montjuïc,18,Sants,5-9,76,70,6
2015,4,Les Corts,19,les Corts,5-9,62,53,9
2015,4,Les Corts,20,la Maternitat i Sant Ramon,5-9,34,34,0
2015,4,Les Corts,21,Pedralbes,5-9,62,19,43
2015,5,Sarrià-Sant Gervasi,22,"Vallvidrera, el Tibidabo i les Planes",5-9,14,14,0
2015,5,Sarrià-Sant Gervasi,23,Sarrià,5-9,70,41,29
2015,5,Sarrià-Sant Gervasi,24,les Tres Torres,5-9,47,30,17
2015,5,Sarrià-Sant Gervasi,25,Sant Gervasi - la Bonanova,5-9,51,29,22
2015,5,Sarrià-Sant Gervasi,26,Sant Gervasi - Galvany,5-9,101,68,33
2015,5,Sarrià-Sant Gervasi,27,el Putxet i el Farró,5-9,49,28,21
2015,6,Gràcia,28,Vallcarca i els Penitents,5-9,20,11,9
2015,6,Gràcia,29,el Coll,5-9,16,13,3
2015,6,Gràcia,30,la Salut,5-9,7,16,-9
2015,6,Gràcia,31,la Vila de Gràcia,5-9,76,40,36
2015,6,Gràcia,32,el Camp d'en Grassot i Gràcia Nova,5-9,45,41,4
2015,7,Horta-Guinardó,33,el Baix Guinardó,5-9,41,23,18
2015,7,Horta-Guinardó,34,Can Baró,5-9,12,11,1
2015,7,Horta-Guinardó,35,el Guinardó,5-9,47,29,18
2015,7,Horta-Guinardó,36,la Font d'en Fargues,5-9,6,8,-2
2015,7,Horta-Guinardó,37,el Carmel,5-9,42,38,4
2015,7,Horta-Guinardó,38,la Teixonera,5-9,9,11,-2
2015,7,Horta-Guinardó,39,Sant Genís dels Agudells,5-9,4,13,-9
2015,7,Horta-Guinardó,40,Montbau,5-9,9,1,8
2015,7,Horta-Guinardó,41,la Vall d'Hebron,5-9,6,3,3
2015,7,Horta-Guinardó,42,la Clota,5-9,0,1,-1
2015,7,Horta-Guinardó,43,Horta,5-9,36,18,18
2015,8,Nou Barris,44,Vilapicina i la Torre Llobeta,5-9,34,25,9
2015,8,Nou Barris,45,Porta,5-9,29,27,2
2015,8,Nou Barris,46,el Turó de la Peira,5-9,35,18,17
2015,8,Nou Barris,47,Can Peguera,5-9,1,2,-1
2015,8,Nou Barris,48,la Guineueta,5-9,15,13,2
2015,8,Nou Barris,49,Canyelles,5-9,7,8,-1
2015,8,Nou Barris,50,les Roquetes,5-9,38,34,4
2015,8,Nou Barris,51,Verdun,5-9,26,20,6
2015,8,Nou Barris,52,la Prosperitat,5-9,39,28,11
2015,8,Nou Barris,53,la Trinitat Nova,5-9,16,11,5
2015,8,Nou Barris,54,Torre Baró,5-9,13,5,8
2015,8,Nou Barris,55,Ciutat Meridiana,5-9,26,34,-8
2015,8,Nou Barris,56,Vallbona,5-9,4,3,1
2015,9,Sant Andreu,57,la Trinitat Vella,5-9,39,30,9
2015,9,Sant Andreu,58,Baró de Viver,5-9,9,12,-3
2015,9,Sant Andreu,59,el Bon Pastor,5-9,23,22,1
2015,9,Sant Andreu,60,Sant Andreu,5-9,73,48,25
2015,9,Sant Andreu,61,la Sagrera,5-9,40,22,18
2015,9,Sant Andreu,62,el Congrés i els Indians,5-9,14,14,0
2015,9,Sant Andreu,63,Navas,5-9,34,22,12
2015,10,Sant Martí,64,el Camp de l'Arpa del Clot,5-9,45,42,3
2015,10,Sant Martí,65,el Clot,5-9,36,29,7
2015,10,Sant Martí,66,el Parc i la Llacuna del Poblenou,5-9,24,26,-2
2015,10,Sant Martí,67,la Vila Olímpica del Poblenou,5-9,18,16,2
2015,10,Sant Martí,68,el Poblenou,5-9,52,44,8
2015,10,Sant Martí,69,Diagonal Mar i el Front Marítim del Poblenou,5-9,28,36,-8
2015,10,Sant Martí,70,el Besòs i el Maresme,5-9,71,90,-19
2015,10,Sant Martí,71,Provençals del Poblenou,5-9,31,19,12
2015,10,Sant Martí,72,Sant Martí de Provençals,5-9,26,28,-2
2015,10,Sant Martí,73,la Verneda i la Pau,5-9,60,40,20
2015,1,Ciutat Vella,1,el Raval,10-14,94,61,33
2015,1,Ciutat Vella,2,el Barri Gòtic,10-14,28,12,16
2015,1,Ciutat Vella,3,la Barceloneta,10-14,18,10,8
2015,1,Ciutat Vella,4,"Sant Pere, Santa Caterina i la Ribera",10-14,33,26,7
2015,2,Eixample,5,el Fort Pienc,10-14,42,17,25
2015,2,Eixample,6,la Sagrada Família,10-14,71,40,31
2015,2,Eixample,7,la Dreta de l'Eixample,10-14,60,38,22
2015,2,Eixample,8,l'Antiga Esquerra de l'Eixample,10-14,61,19,42
2015,2,Eixample,9,la Nova Esquerra de l'Eixample,10-14,91,60,31
2015,2,Eixample,10,Sant Antoni,10-14,47,38,9
2015,3,Sants-Montjuïc,11,el Poble Sec,10-14,70,51,19
2015,3,Sants-Montjuïc,12,la Marina del Prat Vermell,10-14,4,0,4
2015,3,Sants-Montjuïc,13,la Marina de Port,10-14,70,48,22
2015,3,Sants-Montjuïc,14,la Font de la Guatlla,10-14,21,6,15
2015,3,Sants-Montjuïc,15,Hostafrancs,10-14,37,20,17
2015,3,Sants-Montjuïc,16,la Bordeta,10-14,33,16,17
2015,3,Sants-Montjuïc,17,Sants - Badal,10-14,49,25,24
2015,3,Sants-Montjuïc,18,Sants,10-14,84,41,43
2015,4,Les Corts,19,les Corts,10-14,63,36,27
2015,4,Les Corts,20,la Maternitat i Sant Ramon,10-14,39,31,8
2015,4,Les Corts,21,Pedralbes,10-14,50,23,27
2015,5,Sarrià-Sant Gervasi,22,"Vallvidrera, el Tibidabo i les Planes",10-14,13,7,6
2015,5,Sarrià-Sant Gervasi,23,Sarrià,10-14,87,28,59
2015,5,Sarrià-Sant Gervasi,24,les Tres Torres,10-14,38,25,13
2015,5,Sarrià-Sant Gervasi,25,Sant Gervasi - la Bonanova,10-14,45,24,21
2015,5,Sarrià-Sant Gervasi,26,Sant Gervasi - Galvany,10-14,104,51,53
2015,5,Sarrià-Sant Gervasi,27,el Putxet i el Farró,10-14,49,23,26
2015,6,Gràcia,28,Vallcarca i els Penitents,10-14,20,12,8
2015,6,Gràcia,29,el Coll,10-14,15,4,11
2015,6,Gràcia,30,la Salut,10-14,16,7,9
2015,6,Gràcia,31,la Vila de Gràcia,10-14,52,31,21
2015,6,Gràcia,32,el Camp d'en Grassot i Gràcia Nova,10-14,32,18,14
2015,7,Horta-Guinardó,33,el Baix Guinardó,10-14,29,16,13
2015,7,Horta-Guinardó,34,Can Baró,10-14,8,7,1
2015,7,Horta-Guinardó,35,el Guinardó,10-14,59,21,38
2015,7,Horta-Guinardó,36,la Font d'en Fargues,10-14,11,6,5
2015,7,Horta-Guinardó,37,el Carmel,10-14,30,42,-12
2015,7,Horta-Guinardó,38,la Teixonera,10-14,16,5,11
2015,7,Horta-Guinardó,39,Sant Genís dels Agudells,10-14,8,10,-2
2015,7,Horta-Guinardó,40,Montbau,10-14,4,3,1
2015,7,Horta-Guinardó,41,la Vall d'Hebron,10-14,9,6,3
2015,7,Horta-Guinardó,42,la Clota,10-14,0,1,-1
2015,7,Horta-Guinardó,43,Horta,10-14,44,19,25
2015,8,Nou Barris,44,Vilapicina i la Torre Llobeta,10-14,41,17,24
2015,8,Nou Barris,45,Porta,10-14,27,12,15
2015,8,Nou Barris,46,el Turó de la Peira,10-14,28,11,17
2015,8,Nou Barris,47,Can Peguera,10-14,4,0,4
2015,8,Nou Barris,48,la Guineueta,10-14,18,10,8
2015,8,Nou Barris,49,Canyelles,10-14,9,14,-5
2015,8,Nou Barris,50,les Roquetes,10-14,38,18,20
2015,8,Nou Barris,51,Verdun,10-14,20,15,5
2015,8,Nou Barris,52,la Prosperitat,10-14,45,29,16
2015,8,Nou Barris,53,la Trinitat Nova,10-14,16,6,10
2015,8,Nou Barris,54,Torre Baró,10-14,5,5,0
2015,8,Nou Barris,55,Ciutat Meridiana,10-14,28,26,2
2015,8,Nou Barris,56,Vallbona,10-14,4,3,1
2015,9,Sant Andreu,57,la Trinitat Vella,10-14,30,13,17
2015,9,Sant Andreu,58,Baró de Viver,10-14,2,1,1
2015,9,Sant Andreu,59,el Bon Pastor,10-14,20,13,7
2015,9,Sant Andreu,60,Sant Andreu,10-14,50,44,6
2015,9,Sant Andreu,61,la Sagrera,10-14,34,20,14
2015,9,Sant Andreu,62,el Congrés i els Indians,10-14,19,13,6
2015,9,Sant Andreu,63,Navas,10-14,28,17,11
2015,10,Sant Martí,64,el Camp de l'Arpa del Clot,10-14,43,34,9
2015,10,Sant Martí,65,el Clot,10-14,37,17,20
2015,10,Sant Martí,66,el Parc i la Llacuna del Poblenou,10-14,13,15,-2
2015,10,Sant Martí,67,la Vila Olímpica del Poblenou,10-14,11,14,-3
2015,10,Sant Martí,68,el Poblenou,10-14,50,23,27
2015,10,Sant Martí,69,Diagonal Mar i el Front Marítim del Poblenou,10-14,20,19,1
2015,10,Sant Martí,70,el Besòs i el Maresme,10-14,68,60,8
2015,10,Sant Martí,71,Provençals del Poblenou,10-14,39,12,27
2015,10,Sant Martí,72,Sant Martí de Provençals,10-14,35,12,23
2015,10,Sant Martí,73,la Verneda i la Pau,10-14,54,36,18
2015,1,Ciutat Vella,1,el Raval,15-19,232,92,140
2015,1,Ciutat Vella,2,el Barri Gòtic,15-19,77,25,52
2015,1,Ciutat Vella,3,la Barceloneta,15-19,44,13,31
2015,1,Ciutat Vella,4,"Sant Pere, Santa Caterina i la Ribera",15-19,93,38,55
2015,2,Eixample,5,el Fort Pienc,15-19,66,33,33
2015,2,Eixample,6,la Sagrada Família,15-19,93,31,62
2015,2,Eixample,7,la Dreta de l'Eixample,15-19,96,35,61
2015,2,Eixample,8,l'Antiga Esquerra de l'Eixample,15-19,109,35,74
2015,2,Eixample,9,la Nova Esquerra de l'Eixample,15-19,105,46,59
2015,2,Eixample,10,Sant Antoni,15-19,82,37,45
2015,3,Sants-Montjuïc,11,el Poble Sec,15-19,125,56,69
2015,3,Sants-Montjuïc,12,la Marina del Prat Vermell,15-19,2,2,0
2015,3,Sants-Montjuïc,13,la Marina de Port,15-19,87,28,59
2015,3,Sants-Montjuïc,14,la Font de la Guatlla,15-19,32,16,16
2015,3,Sants-Montjuïc,15,Hostafrancs,15-19,45,13,32
2015,3,Sants-Montjuïc,16,la Bordeta,15-19,28,23,5
2015,3,Sants-Montjuïc,17,Sants - Badal,15-19,59,27,32
2015,3,Sants-Montjuïc,18,Sants,15-19,107,45,62
2015,4,Les Corts,19,les Corts,15-19,88,28,60
2015,4,Les Corts,20,la Maternitat i Sant Ramon,15-19,60,18,42
2015,4,Les Corts,21,Pedralbes,15-19,41,21,20
2015,5,Sarrià-Sant Gervasi,22,"Vallvidrera, el Tibidabo i les Planes",15-19,11,3,8
2015,5,Sarrià-Sant Gervasi,23,Sarrià,15-19,71,31,40
2015,5,Sarrià-Sant Gervasi,24,les Tres Torres,15-19,46,12,34
2015,5,Sarrià-Sant Gervasi,25,Sant Gervasi - la Bonanova,15-19,84,19,65
2015,5,Sarrià-Sant Gervasi,26,Sant Gervasi - Galvany,15-19,118,35,83
2015,5,Sarrià-Sant Gervasi,27,el Putxet i el Farró,15-19,73,24,49
2015,6,Gràcia,28,Vallcarca i els Penitents,15-19,18,10,8
2015,6,Gràcia,29,el Coll,15-19,15,4,11
2015,6,Gràcia,30,la Salut,15-19,47,16,31
2015,6,Gràcia,31,la Vila de Gràcia,15-19,94,21,73
2015,6,Gràcia,32,el Camp d'en Grassot i Gràcia Nova,15-19,39,15,24
2015,7,Horta-Guinardó,33,el Baix Guinardó,15-19,40,18,22
2015,7,Horta-Guinardó,34,Can Baró,15-19,10,10,0
2015,7,Horta-Guinardó,35,el Guinardó,15-19,65,32,33
2015,7,Horta-Guinardó,36,la Font d'en Fargues,15-19,9,7,2
2015,7,Horta-Guinardó,37,el Carmel,15-19,56,40,16
2015,7,Horta-Guinardó,38,la Teixonera,15-19,14,9,5
2015,7,Horta-Guinardó,39,Sant Genís dels Agudells,15-19,12,13,-1
2015,7,Horta-Guinardó,40,Montbau,15-19,16,5,11
2015,7,Horta-Guinardó,41,la Vall d'Hebron,15-19,8,3,5
2015,7,Horta-Guinardó,42,la Clota,15-19,0,1,-1
2015,7,Horta-Guinardó,43,Horta,15-19,64,23,41
2015,8,Nou Barris,44,Vilapicina i la Torre Llobeta,15-19,51,17,34
2015,8,Nou Barris,45,Porta,15-19,46,25,21
2015,8,Nou Barris,46,el Turó de la Peira,15-19,48,20,28
2015,8,Nou Barris,47,Can Peguera,15-19,0,7,-7
2015,8,Nou Barris,48,la Guineueta,15-19,17,10,7
2015,8,Nou Barris,49,Canyelles,15-19,7,4,3
2015,8,Nou Barris,50,les Roquetes,15-19,48,31,17
2015,8,Nou Barris,51,Verdun,15-19,31,11,20
2015,8,Nou Barris,52,la Prosperitat,15-19,45,29,16
2015,8,Nou Barris,53,la Trinitat Nova,15-19,28,10,18
2015,8,Nou Barris,54,Torre Baró,15-19,16,9,7
2015,8,Nou Barris,55,Ciutat Meridiana,15-19,31,26,5
2015,8,Nou Barris,56,Vallbona,15-19,2,3,-1
2015,9,Sant Andreu,57,la Trinitat Vella,15-19,33,17,16
2015,9,Sant Andreu,58,Baró de Viver,15-19,3,3,0
2015,9,Sant Andreu,59,el Bon Pastor,15-19,38,14,24
2015,9,Sant Andreu,60,Sant Andreu,15-19,62,39,23
2015,9,Sant Andreu,61,la Sagrera,15-19,48,25,23
2015,9,Sant Andreu,62,el Congrés i els Indians,15-19,20,11,9
2015,9,Sant Andreu,63,Navas,15-19,50,19,31
2015,10,Sant Martí,64,el Camp de l'Arpa del Clot,15-19,77,34,43
2015,10,Sant Martí,65,el Clot,15-19,34,25,9
2015,10,Sant Martí,66,el Parc i la Llacuna del Poblenou,15-19,46,12,34
2015,10,Sant Martí,67,la Vila Olímpica del Poblenou,15-19,11,4,7
2015,10,Sant Martí,68,el Poblenou,15-19,44,36,8
2015,10,Sant Martí,69,Diagonal Mar i el Front Marítim del Poblenou,15-19,23,17,6
2015,10,Sant Martí,70,el Besòs i el Maresme,15-19,91,48,43
2015,10,Sant Martí,71,Provençals del Poblenou,15-19,41,22,19
2015,10,Sant Martí,72,Sant Martí de Provençals,15-19,46,27,19
2015,10,Sant Martí,73,la Verneda i la Pau,15-19,46,40,6
2015,1,Ciutat Vella,1,el Raval,20-24,752,176,576
2015,1,Ciutat Vella,2,el Barri Gòtic,20-24,423,58,365
2015,1,Ciutat Vella,3,la Barceloneta,20-24,234,38,196
2015,1,Ciutat Vella,4,"Sant Pere, Santa Caterina i la Ribera",20-24,388,64,324
2015,2,Eixample,5,el Fort Pienc,20-24,266,68,198
2015,2,Eixample,6,la Sagrada Família,20-24,408,102,306
2015,2,Eixample,7,la Dreta de l'Eixample,20-24,400,56,344
2015,2,Eixample,8,l'Antiga Esquerra de l'Eixample,20-24,383,76,307
2015,2,Eixample,9,la Nova Esquerra de l'Eixample,20-24,454,128,326
2015,2,Eixample,10,Sant Antoni,20-24,272,74,198
2015,3,Sants-Montjuïc,11,el Poble Sec,20-24,338,106,232
2015,3,Sants-Montjuïc,12,la Marina del Prat Vermell,20-24,6,4,2
2015,3,Sants-Montjuïc,13,la Marina de Port,20-24,126,72,54
2015,3,Sants-Montjuïc,14,la Font de la Guatlla,20-24,93,32,61
2015,3,Sants-Montjuïc,15,Hostafrancs,20-24,132,36,96
2015,3,Sants-Montjuïc,16,la Bordeta,20-24,98,48,50
2015,3,Sants-Montjuïc,17,Sants - Badal,20-24,194,75,119
2015,3,Sants-Montjuïc,18,Sants,20-24,251,123,128
2015,4,Les Corts,19,les Corts,20-24,189,65,124
2015,4,Les Corts,20,la Maternitat i Sant Ramon,20-24,124,48,76
2015,4,Les Corts,21,Pedralbes,20-24,57,12,45
2015,5,Sarrià-Sant Gervasi,22,"Vallvidrera, el Tibidabo i les Planes",20-24,13,3,10
2015,5,Sarrià-Sant Gervasi,23,Sarrià,20-24,80,36,44
2015,5,Sarrià-Sant Gervasi,24,les Tres Torres,20-24,83,16,67
2015,5,Sarrià-Sant Gervasi,25,Sant Gervasi - la Bonanova,20-24,130,45,85
2015,5,Sarrià-Sant Gervasi,26,Sant Gervasi - Galvany,20-24,242,61,181
2015,5,Sarrià-Sant Gervasi,27,el Putxet i el Farró,20-24,137,42,95
2015,6,Gràcia,28,Vallcarca i els Penitents,20-24,68,14,54
2015,6,Gràcia,29,el Coll,20-24,43,11,32
2015,6,Gràcia,30,la Salut,20-24,65,23,42
2015,6,Gràcia,31,la Vila de Gràcia,20-24,437,86,351
2015,6,Gràcia,32,el Camp d'en Grassot i Gràcia Nova,20-24,172,48,124
2015,7,Horta-Guinardó,33,el Baix Guinardó,20-24,130,39,91
2015,7,Horta-Guinardó,34,Can Baró,20-24,42,11,31
2015,7,Horta-Guinardó,35,el Guinardó,20-24,170,66,104
2015,7,Horta-Guinardó,36,la Font d'en Fargues,20-24,21,9,12
2015,7,Horta-Guinardó,37,el Carmel,20-24,129,68,61
2015,7,Horta-Guinardó,38,la Teixonera,20-24,57,29,28
2015,7,Horta-Guinardó,39,Sant Genís dels Agudells,20-24,36,12,24
2015,7,Horta-Guinardó,40,Montbau,20-24,22,5,17
2015,7,Horta-Guinardó,41,la Vall d'Hebron,20-24,13,8,5
2015,7,Horta-Guinardó,42,la Clota,20-24,5,0,5
2015,7,Horta-Guinardó,43,Horta,20-24,89,34,55
2015,8,Nou Barris,44,Vilapicina i la Torre Llobeta,20-24,109,50,59
2015,8,Nou Barris,45,Porta,20-24,109,34,75
2015,8,Nou Barris,46,el Turó de la Peira,20-24,76,48,28
2015,8,Nou Barris,47,Can Peguera,20-24,2,5,-3
2015,8,Nou Barris,48,la Guineueta,20-24,34,18,16
2015,8,Nou Barris,49,Canyelles,20-24,7,6,1
2015,8,Nou Barris,50,les Roquetes,20-24,116,51,65
2015,8,Nou Barris,51,Verdun,20-24,81,29,52
2015,8,Nou Barris,52,la Prosperitat,20-24,118,60,58
2015,8,Nou Barris,53,la Trinitat Nova,20-24,41,26,15
2015,8,Nou Barris,54,Torre Baró,20-24,14,3,11
2015,8,Nou Barris,55,Ciutat Meridiana,20-24,82,49,33
2015,8,Nou Barris,56,Vallbona,20-24,6,4,2
2015,9,Sant Andreu,57,la Trinitat Vella,20-24,88,39,49
2015,9,Sant Andreu,58,Baró de Viver,20-24,9,6,3
2015,9,Sant Andreu,59,el Bon Pastor,20-24,55,22,33
2015,9,Sant Andreu,60,Sant Andreu,20-24,148,80,68
2015,9,Sant Andreu,61,la Sagrera,20-24,121,45,76
2015,9,Sant Andreu,62,el Congrés i els Indians,20-24,66,30,36
2015,9,Sant Andreu,63,Navas,20-24,97,33,64
2015,10,Sant Martí,64,el Camp de l'Arpa del Clot,20-24,199,78,121
2015,10,Sant Martí,65,el Clot,20-24,118,41,77
2015,10,Sant Martí,66,el Parc i la Llacuna del Poblenou,20-24,161,35,126
2015,10,Sant Martí,67,la Vila Olímpica del Poblenou,20-24,35,11,24
2015,10,Sant Martí,68,el Poblenou,20-24,103,46,57
2015,10,Sant Martí,69,Diagonal Mar i el Front Marítim del Poblenou,20-24,51,17,34
2015,10,Sant Martí,70,el Besòs i el Maresme,20-24,152,101,51
2015,10,Sant Martí,71,Provençals del Poblenou,20-24,85,27,58
2015,10,Sant Martí,72,Sant Martí de Provençals,20-24,99,49,50
2015,10,Sant Martí,73,la Verneda i la Pau,20-24,107,58,49
2015,1,Ciutat Vella,1,el Raval,25-29,1242,342,900
2015,1,Ciutat Vella,2,el Barri Gòtic,25-29,580,90,490
2015,1,Ciutat Vella,3,la Barceloneta,25-29,414,100,314
2015,1,Ciutat Vella,4,"Sant Pere, Santa Caterina i la Ribera",25-29,684,140,544
2015,2,Eixample,5,el Fort Pienc,25-29,445,139,306
2015,2,Eixample,6,la Sagrada Família,25-29,803,220,583
2015,2,Eixample,7,la Dreta de l'Eixample,25-29,705,162,543
2015,2,Eixample,8,l'Antiga Esquerra de l'Eixample,25-29,742,188,554
2015,2,Eixample,9,la Nova Esquerra de l'Eixample,25-29,841,238,603
2015,2,Eixample,10,Sant Antoni,25-29,520,183,337
2015,3,Sants-Montjuïc,11,el Poble Sec,25-29,628,214,414
2015,3,Sants-Montjuïc,12,la Marina del Prat Vermell,25-29,3,3,0
2015,3,Sants-Montjuïc,13,la Marina de Port,25-29,212,116,96
2015,3,Sants-Montjuïc,14,la Font de la Guatlla,25-29,184,59,125
2015,3,Sants-Montjuïc,15,Hostafrancs,25-29,239,79,160
2015,3,Sants-Montjuïc,16,la Bordeta,25-29,167,105,62
2015,3,Sants-Montjuïc,17,Sants - Badal,25-29,291,158,133
2015,3,Sants-Montjuïc,18,Sants,25-29,528,230,298
2015,4,Les Corts,19,les Corts,25-29,398,206,192
2015,4,Les Corts,20,la Maternitat i Sant Ramon,25-29,259,113,146
2015,4,Les Corts,21,Pedralbes,25-29,81,42,39
2015,5,Sarrià-Sant Gervasi,22,"Vallvidrera, el Tibidabo i les Planes",25-29,25,14,11
2015,5,Sarrià-Sant Gervasi,23,Sarrià,25-29,145,68,77
2015,5,Sarrià-Sant Gervasi,24,les Tres Torres,25-29,58,36,22
2015,5,Sarrià-Sant Gervasi,25,Sant Gervasi - la Bonanova,25-29,167,92,75
2015,5,Sarrià-Sant Gervasi,26,Sant Gervasi - Galvany,25-29,313,133,180
2015,5,Sarrià-Sant Gervasi,27,el Putxet i el Farró,25-29,281,86,195
2015,6,Gràcia,28,Vallcarca i els Penitents,25-29,134,58,76
2015,6,Gràcia,29,el Coll,25-29,74,24,50
2015,6,Gràcia,30,la Salut,25-29,91,39,52
2015,6,Gràcia,31,la Vila de Gràcia,25-29,872,227,645
2015,6,Gràcia,32,el Camp d'en Grassot i Gràcia Nova,25-29,377,104,273
2015,7,Horta-Guinardó,33,el Baix Guinardó,25-29,238,100,138
2015,7,Horta-Guinardó,34,Can Baró,25-29,93,29,64
2015,7,Horta-Guinardó,35,el Guinardó,25-29,302,127,175
2015,7,Horta-Guinardó,36,la Font d'en Fargues,25-29,29,16,13
2015,7,Horta-Guinardó,37,el Carmel,25-29,192,109,83
2015,7,Horta-Guinardó,38,la Teixonera,25-29,71,43,28
2015,7,Horta-Guinardó,39,Sant Genís dels Agudells,25-29,42,15,27
2015,7,Horta-Guinardó,40,Montbau,25-29,38,16,22
2015,7,Horta-Guinardó,41,la Vall d'Hebron,25-29,31,9,22
2015,7,Horta-Guinardó,42,la Clota,25-29,4,3,1
2015,7,Horta-Guinardó,43,Horta,25-29,143,60,83
2015,8,Nou Barris,44,Vilapicina i la Torre Llobeta,25-29,147,88,59
2015,8,Nou Barris,45,Porta,25-29,155,63,92
2015,8,Nou Barris,46,el Turó de la Peira,25-29,120,53,67
2015,8,Nou Barris,47,Can Peguera,25-29,3,6,-3
2015,8,Nou Barris,48,la Guineueta,25-29,64,45,19
2015,8,Nou Barris,49,Canyelles,25-29,22,19,3
2015,8,Nou Barris,50,les Roquetes,25-29,116,63,53
2015,8,Nou Barris,51,Verdun,25-29,103,56,47
2015,8,Nou Barris,52,la Prosperitat,25-29,175,92,83
2015,8,Nou Barris,53,la Trinitat Nova,25-29,60,36,24
2015,8,Nou Barris,54,Torre Baró,25-29,16,8,8
2015,8,Nou Barris,55,Ciutat Meridiana,25-29,82,71,11
2015,8,Nou Barris,56,Vallbona,25-29,11,7,4
2015,9,Sant Andreu,57,la Trinitat Vella,25-29,100,59,41
2015,9,Sant Andreu,58,Baró de Viver,25-29,10,7,3
2015,9,Sant Andreu,59,el Bon Pastor,25-29,78,29,49
2015,9,Sant Andreu,60,Sant Andreu,25-29,281,170,111
2015,9,Sant Andreu,61,la Sagrera,25-29,192,103,89
2015,9,Sant Andreu,62,el Congrés i els Indians,25-29,104,46,58
2015,9,Sant Andreu,63,Navas,25-29,168,61,107
2015,10,Sant Martí,64,el Camp de l'Arpa del Clot,25-29,408,150,258
2015,10,Sant Martí,65,el Clot,25-29,213,114,99
2015,10,Sant Martí,66,el Parc i la Llacuna del Poblenou,25-29,158,68,90
2015,10,Sant Martí,67,la Vila Olímpica del Poblenou,25-29,69,21,48
2015,10,Sant Martí,68,el Poblenou,25-29,285,114,171
2015,10,Sant Martí,69,Diagonal Mar i el Front Marítim del Poblenou,25-29,81,28,53
2015,10,Sant Martí,70,el Besòs i el Maresme,25-29,240,156,84
2015,10,Sant Martí,71,Provençals del Poblenou,25-29,148,68,80
2015,10,Sant Martí,72,Sant Martí de Provençals,25-29,167,93,74
2015,10,Sant Martí,73,la Verneda i la Pau,25-29,156,102,54
2015,1,Ciutat Vella,1,el Raval,30-34,958,451,507
2015,1,Ciutat Vella,2,el Barri Gòtic,30-34,347,119,228
2015,1,Ciutat Vella,3,la Barceloneta,30-34,340,120,220
2015,1,Ciutat Vella,4,"Sant Pere, Santa Caterina i la Ribera",30-34,477,170,307
2015,2,Eixample,5,el Fort Pienc,30-34,347,168,179
2015,2,Eixample,6,la Sagrada Família,30-34,585,293,292
2015,2,Eixample,7,la Dreta de l'Eixample,30-34,470,248,222
2015,2,Eixample,8,l'Antiga Esquerra de l'Eixample,30-34,510,237,273
2015,2,Eixample,9,la Nova Esquerra de l'Eixample,30-34,604,326,278
2015,2,Eixample,10,Sant Antoni,30-34,428,222,206
2015,3,Sants-Montjuïc,11,el Poble Sec,30-34,542,294,248
2015,3,Sants-Montjuïc,12,la Marina del Prat Vermell,30-34,16,10,6
2015,3,Sants-Montjuïc,13,la Marina de Port,30-34,197,149,48
2015,3,Sants-Montjuïc,14,la Font de la Guatlla,30-34,119,88,31
2015,3,Sants-Montjuïc,15,Hostafrancs,30-34,229,131,98
2015,3,Sants-Montjuïc,16,la Bordeta,30-34,155,132,23
2015,3,Sants-Montjuïc,17,Sants - Badal,30-34,227,173,54
2015,3,Sants-Montjuïc,18,Sants,30-34,432,312,120
2015,4,Les Corts,19,les Corts,30-34,325,230,95
2015,4,Les Corts,20,la Maternitat i Sant Ramon,30-34,222,128,94
2015,4,Les Corts,21,Pedralbes,30-34,71,56,15
2015,5,Sarrià-Sant Gervasi,22,"Vallvidrera, el Tibidabo i les Planes",30-34,29,21,8
2015,5,Sarrià-Sant Gervasi,23,Sarrià,30-34,115,95,20
2015,5,Sarrià-Sant Gervasi,24,les Tres Torres,30-34,65,47,18
2015,5,Sarrià-Sant Gervasi,25,Sant Gervasi - la Bonanova,30-34,155,101,54
2015,5,Sarrià-Sant Gervasi,26,Sant Gervasi - Galvany,30-34,325,186,139
2015,5,Sarrià-Sant Gervasi,27,el Putxet i el Farró,30-34,259,154,105
2015,6,Gràcia,28,Vallcarca i els Penitents,30-34,116,65,51
2015,6,Gràcia,29,el Coll,30-34,52,28,24
2015,6,Gràcia,30,la Salut,30-34,92,63,29
2015,6,Gràcia,31,la Vila de Gràcia,30-34,729,324,405
2015,6,Gràcia,32,el Camp d'en Grassot i Gràcia Nova,30-34,317,155,162
2015,7,Horta-Guinardó,33,el Baix Guinardó,30-34,216,126,90
2015,7,Horta-Guinardó,34,Can Baró,30-34,53,45,8
2015,7,Horta-Guinardó,35,el Guinardó,30-34,301,165,136
2015,7,Horta-Guinardó,36,la Font d'en Fargues,30-34,36,30,6
2015,7,Horta-Guinardó,37,el Carmel,30-34,181,130,51
2015,7,Horta-Guinardó,38,la Teixonera,30-34,68,45,23
2015,7,Horta-Guinardó,39,Sant Genís dels Agudells,30-34,47,31,16
2015,7,Horta-Guinardó,40,Montbau,30-34,17,17,0
2015,7,Horta-Guinardó,41,la Vall d'Hebron,30-34,22,12,10
2015,7,Horta-Guinardó,42,la Clota,30-34,6,2,4
2015,7,Horta-Guinardó,43,Horta,30-34,122,101,21
2015,8,Nou Barris,44,Vilapicina i la Torre Llobeta,30-34,135,92,43
2015,8,Nou Barris,45,Porta,30-34,134,70,64
2015,8,Nou Barris,46,el Turó de la Peira,30-34,99,55,44
2015,8,Nou Barris,47,Can Peguera,30-34,3,8,-5
2015,8,Nou Barris,48,la Guineueta,30-34,54,54,0
2015,8,Nou Barris,49,Canyelles,30-34,15,22,-7
2015,8,Nou Barris,50,les Roquetes,30-34,126,79,47
2015,8,Nou Barris,51,Verdun,30-34,70,59,11
2015,8,Nou Barris,52,la Prosperitat,30-34,142,110,32
2015,8,Nou Barris,53,la Trinitat Nova,30-34,48,41,7
2015,8,Nou Barris,54,Torre Baró,30-34,11,14,-3
2015,8,Nou Barris,55,Ciutat Meridiana,30-34,81,75,6
2015,8,Nou Barris,56,Vallbona,30-34,5,5,0
2015,9,Sant Andreu,57,la Trinitat Vella,30-34,107,78,29
2015,9,Sant Andreu,58,Baró de Viver,30-34,15,14,1
2015,9,Sant Andreu,59,el Bon Pastor,30-34,70,61,9
2015,9,Sant Andreu,60,Sant Andreu,30-34,270,202,68
2015,9,Sant Andreu,61,la Sagrera,30-34,182,103,79
2015,9,Sant Andreu,62,el Congrés i els Indians,30-34,88,65,23
2015,9,Sant Andreu,63,Navas,30-34,126,96,30
2015,10,Sant Martí,64,el Camp de l'Arpa del Clot,30-34,347,205,142
2015,10,Sant Martí,65,el Clot,30-34,226,134,92
2015,10,Sant Martí,66,el Parc i la Llacuna del Poblenou,30-34,147,81,66
2015,10,Sant Martí,67,la Vila Olímpica del Poblenou,30-34,71,42,29
2015,10,Sant Martí,68,el Poblenou,30-34,310,141,169
2015,10,Sant Martí,69,Diagonal Mar i el Front Marítim del Poblenou,30-34,98,60,38
2015,10,Sant Martí,70,el Besòs i el Maresme,30-34,213,147,66
2015,10,Sant Martí,71,Provençals del Poblenou,30-34,142,100,42
2015,10,Sant Martí,72,Sant Martí de Provençals,30-34,129,95,34
2015,10,Sant Martí,73,la Verneda i la Pau,30-34,142,104,38
2015,1,Ciutat Vella,1,el Raval,35-39,593,348,245
2015,1,Ciutat Vella,2,el Barri Gòtic,35-39,227,123,104
2015,1,Ciutat Vella,3,la Barceloneta,35-39,160,96,64
2015,1,Ciutat Vella,4,"Sant Pere, Santa Caterina i la Ribera",35-39,300,185,115
2015,2,Eixample,5,el Fort Pienc,35-39,219,127,92
2015,2,Eixample,6,la Sagrada Família,35-39,380,278,102
2015,2,Eixample,7,la Dreta de l'Eixample,35-39,316,210,106
2015,2,Eixample,8,l'Antiga Esquerra de l'Eixample,35-39,277,195,82
2015,2,Eixample,9,la Nova Esquerra de l'Eixample,35-39,381,295,86
2015,2,Eixample,10,Sant Antoni,35-39,290,207,83
2015,3,Sants-Montjuïc,11,el Poble Sec,35-39,388,315,73
2015,3,Sants-Montjuïc,12,la Marina del Prat Vermell,35-39,6,5,1
2015,3,Sants-Montjuïc,13,la Marina de Port,35-39,171,143,28
2015,3,Sants-Montjuïc,14,la Font de la Guatlla,35-39,83,62,21
2015,3,Sants-Montjuïc,15,Hostafrancs,35-39,133,109,24
2015,3,Sants-Montjuïc,16,la Bordeta,35-39,129,115,14
2015,3,Sants-Montjuïc,17,Sants - Badal,35-39,172,161,11
2015,3,Sants-Montjuïc,18,Sants,35-39,307,247,60
2015,4,Les Corts,19,les Corts,35-39,263,188,75
2015,4,Les Corts,20,la Maternitat i Sant Ramon,35-39,142,115,27
2015,4,Les Corts,21,Pedralbes,35-39,72,49,23
2015,5,Sarrià-Sant Gervasi,22,"Vallvidrera, el Tibidabo i les Planes",35-39,27,19,8
2015,5,Sarrià-Sant Gervasi,23,Sarrià,35-39,117,71,46
2015,5,Sarrià-Sant Gervasi,24,les Tres Torres,35-39,74,43,31
2015,5,Sarrià-Sant Gervasi,25,Sant Gervasi - la Bonanova,35-39,117,73,44
2015,5,Sarrià-Sant Gervasi,26,Sant Gervasi - Galvany,35-39,218,164,54
2015,5,Sarrià-Sant Gervasi,27,el Putxet i el Farró,35-39,165,120,45
2015,6,Gràcia,28,Vallcarca i els Penitents,35-39,81,59,22
2015,6,Gràcia,29,el Coll,35-39,41,46,-5
2015,6,Gràcia,30,la Salut,35-39,62,50,12
2015,6,Gràcia,31,la Vila de Gràcia,35-39,404,293,111
2015,6,Gràcia,32,el Camp d'en Grassot i Gràcia Nova,35-39,214,155,59
2015,7,Horta-Guinardó,33,el Baix Guinardó,35-39,120,92,28
2015,7,Horta-Guinardó,34,Can Baró,35-39,46,27,19
2015,7,Horta-Guinardó,35,el Guinardó,35-39,189,142,47
2015,7,Horta-Guinardó,36,la Font d'en Fargues,35-39,29,28,1
2015,7,Horta-Guinardó,37,el Carmel,35-39,133,125,8
2015,7,Horta-Guinardó,38,la Teixonera,35-39,43,43,0
2015,7,Horta-Guinardó,39,Sant Genís dels Agudells,35-39,30,31,-1
2015,7,Horta-Guinardó,40,Montbau,35-39,28,14,14
2015,7,Horta-Guinardó,41,la Vall d'Hebron,35-39,18,11,7
2015,7,Horta-Guinardó,42,la Clota,35-39,2,2,0
2015,7,Horta-Guinardó,43,Horta,35-39,126,75,51
2015,8,Nou Barris,44,Vilapicina i la Torre Llobeta,35-39,105,84,21
2015,8,Nou Barris,45,Porta,35-39,116,73,43
2015,8,Nou Barris,46,el Turó de la Peira,35-39,92,59,33
2015,8,Nou Barris,47,Can Peguera,35-39,8,5,3
2015,8,Nou Barris,48,la Guineueta,35-39,43,45,-2
2015,8,Nou Barris,49,Canyelles,35-39,20,18,2
2015,8,Nou Barris,50,les Roquetes,35-39,103,79,24
2015,8,Nou Barris,51,Verdun,35-39,83,56,27
2015,8,Nou Barris,52,la Prosperitat,35-39,128,100,28
2015,8,Nou Barris,53,la Trinitat Nova,35-39,46,32,14
2015,8,Nou Barris,54,Torre Baró,35-39,15,13,2
2015,8,Nou Barris,55,Ciutat Meridiana,35-39,85,69,16
2015,8,Nou Barris,56,Vallbona,35-39,9,12,-3
2015,9,Sant Andreu,57,la Trinitat Vella,35-39,90,83,7
2015,9,Sant Andreu,58,Baró de Viver,35-39,12,14,-2
2015,9,Sant Andreu,59,el Bon Pastor,35-39,63,63,0
2015,9,Sant Andreu,60,Sant Andreu,35-39,239,196,43
2015,9,Sant Andreu,61,la Sagrera,35-39,149,126,23
2015,9,Sant Andreu,62,el Congrés i els Indians,35-39,61,42,19
2015,9,Sant Andreu,63,Navas,35-39,96,82,14
2015,10,Sant Martí,64,el Camp de l'Arpa del Clot,35-39,218,206,12
2015,10,Sant Martí,65,el Clot,35-39,157,118,39
2015,10,Sant Martí,66,el Parc i la Llacuna del Poblenou,35-39,105,73,32
2015,10,Sant Martí,67,la Vila Olímpica del Poblenou,35-39,66,31,35
2015,10,Sant Martí,68,el Poblenou,35-39,228,144,84
2015,10,Sant Martí,69,Diagonal Mar i el Front Marítim del Poblenou,35-39,99,65,34
2015,10,Sant Martí,70,el Besòs i el Maresme,35-39,224,166,58
2015,10,Sant Martí,71,Provençals del Poblenou,35-39,120,76,44
2015,10,Sant Martí,72,Sant Martí de Provençals,35-39,98,72,26
2015,10,Sant Martí,73,la Verneda i la Pau,35-39,118,96,22
2015,1,Ciutat Vella,1,el Raval,40-44,396,273,123
2015,1,Ciutat Vella,2,el Barri Gòtic,40-44,147,92,55
2015,1,Ciutat Vella,3,la Barceloneta,40-44,115,80,35
2015,1,Ciutat Vella,4,"Sant Pere, Santa Caterina i la Ribera",40-44,158,105,53
2015,2,Eixample,5,el Fort Pienc,40-44,166,117,49
2015,2,Eixample,6,la Sagrada Família,40-44,220,160,60
2015,2,Eixample,7,la Dreta de l'Eixample,40-44,191,146,45
2015,2,Eixample,8,l'Antiga Esquerra de l'Eixample,40-44,200,135,65
2015,2,Eixample,9,la Nova Esquerra de l'Eixample,40-44,224,175,49
2015,2,Eixample,10,Sant Antoni,40-44,175,133,42
2015,3,Sants-Montjuïc,11,el Poble Sec,40-44,207,194,13
2015,3,Sants-Montjuïc,12,la Marina del Prat Vermell,40-44,1,2,-1
2015,3,Sants-Montjuïc,13,la Marina de Port,40-44,121,95,26
2015,3,Sants-Montjuïc,14,la Font de la Guatlla,40-44,46,32,14
2015,3,Sants-Montjuïc,15,Hostafrancs,40-44,90,76,14
2015,3,Sants-Montjuïc,16,la Bordeta,40-44,61,59,2
2015,3,Sants-Montjuïc,17,Sants - Badal,40-44,99,104,-5
2015,3,Sants-Montjuïc,18,Sants,40-44,190,166,24
2015,4,Les Corts,19,les Corts,40-44,163,136,27
2015,4,Les Corts,20,la Maternitat i Sant Ramon,40-44,110,75,35
2015,4,Les Corts,21,Pedralbes,40-44,78,39,39
2015,5,Sarrià-Sant Gervasi,22,"Vallvidrera, el Tibidabo i les Planes",40-44,23,24,-1
2015,5,Sarrià-Sant Gervasi,23,Sarrià,40-44,132,92,40
2015,5,Sarrià-Sant Gervasi,24,les Tres Torres,40-44,57,45,12
2015,5,Sarrià-Sant Gervasi,25,Sant Gervasi - la Bonanova,40-44,105,64,41
2015,5,Sarrià-Sant Gervasi,26,Sant Gervasi - Galvany,40-44,180,123,57
2015,5,Sarrià-Sant Gervasi,27,el Putxet i el Farró,40-44,92,59,33
2015,6,Gràcia,28,Vallcarca i els Penitents,40-44,52,43,9
2015,6,Gràcia,29,el Coll,40-44,26,32,-6
2015,6,Gràcia,30,la Salut,40-44,32,41,-9
2015,6,Gràcia,31,la Vila de Gràcia,40-44,234,178,56
2015,6,Gràcia,32,el Camp d'en Grassot i Gràcia Nova,40-44,102,99,3
2015,7,Horta-Guinardó,33,el Baix Guinardó,40-44,85,73,12
2015,7,Horta-Guinardó,34,Can Baró,40-44,25,26,-1
2015,7,Horta-Guinardó,35,el Guinardó,40-44,137,104,33
2015,7,Horta-Guinardó,36,la Font d'en Fargues,40-44,26,19,7
2015,7,Horta-Guinardó,37,el Carmel,40-44,87,75,12
2015,7,Horta-Guinardó,38,la Teixonera,40-44,29,38,-9
2015,7,Horta-Guinardó,39,Sant Genís dels Agudells,40-44,13,24,-11
2015,7,Horta-Guinardó,40,Montbau,40-44,16,8,8
2015,7,Horta-Guinardó,41,la Vall d'Hebron,40-44,20,9,11
2015,7,Horta-Guinardó,42,la Clota,40-44,4,1,3
2015,7,Horta-Guinardó,43,Horta,40-44,76,69,7
2015,8,Nou Barris,44,Vilapicina i la Torre Llobeta,40-44,98,68,30
2015,8,Nou Barris,45,Porta,40-44,120,78,42
2015,8,Nou Barris,46,el Turó de la Peira,40-44,70,51,19
2015,8,Nou Barris,47,Can Peguera,40-44,7,5,2
2015,8,Nou Barris,48,la Guineueta,40-44,54,38,16
2015,8,Nou Barris,49,Canyelles,40-44,20,11,9
2015,8,Nou Barris,50,les Roquetes,40-44,60,53,7
2015,8,Nou Barris,51,Verdun,40-44,45,48,-3
2015,8,Nou Barris,52,la Prosperitat,40-44,76,82,-6
2015,8,Nou Barris,53,la Trinitat Nova,40-44,37,28,9
2015,8,Nou Barris,54,Torre Baró,40-44,10,13,-3
2015,8,Nou Barris,55,Ciutat Meridiana,40-44,42,56,-14
2015,8,Nou Barris,56,Vallbona,40-44,4,0,4
2015,9,Sant Andreu,57,la Trinitat Vella,40-44,62,48,14
2015,9,Sant Andreu,58,Baró de Viver,40-44,10,12,-2
2015,9,Sant Andreu,59,el Bon Pastor,40-44,67,49,18
2015,9,Sant Andreu,60,Sant Andreu,40-44,166,143,23
2015,9,Sant Andreu,61,la Sagrera,40-44,97,83,14
2015,9,Sant Andreu,62,el Congrés i els Indians,40-44,46,38,8
2015,9,Sant Andreu,63,Navas,40-44,78,67,11
2015,10,Sant Martí,64,el Camp de l'Arpa del Clot,40-44,154,109,45
2015,10,Sant Martí,65,el Clot,40-44,95,85,10
2015,10,Sant Martí,66,el Parc i la Llacuna del Poblenou,40-44,68,57,11
2015,10,Sant Martí,67,la Vila Olímpica del Poblenou,40-44,53,30,23
2015,10,Sant Martí,68,el Poblenou,40-44,156,125,31
2015,10,Sant Martí,69,Diagonal Mar i el Front Marítim del Poblenou,40-44,78,56,22
2015,10,Sant Martí,70,el Besòs i el Maresme,40-44,138,128,10
2015,10,Sant Martí,71,Provençals del Poblenou,40-44,94,55,39
2015,10,Sant Martí,72,Sant Martí de Provençals,40-44,77,70,7
2015,10,Sant Martí,73,la Verneda i la Pau,40-44,101,98,3
2015,1,Ciutat Vella,1,el Raval,45-49,280,176,104
2015,1,Ciutat Vella,2,el Barri Gòtic,45-49,96,57,39
2015,1,Ciutat Vella,3,la Barceloneta,45-49,66,30,36
2015,1,Ciutat Vella,4,"Sant Pere, Santa Caterina i la Ribera",45-49,105,70,35
2015,2,Eixample,5,el Fort Pienc,45-49,94,69,25
2015,2,Eixample,6,la Sagrada Família,45-49,141,106,35
2015,2,Eixample,7,la Dreta de l'Eixample,45-49,139,96,43
2015,2,Eixample,8,l'Antiga Esquerra de l'Eixample,45-49,140,81,59
2015,2,Eixample,9,la Nova Esquerra de l'Eixample,45-49,161,99,62
2015,2,Eixample,10,Sant Antoni,45-49,91,97,-6
2015,3,Sants-Montjuïc,11,el Poble Sec,45-49,144,124,20
2015,3,Sants-Montjuïc,12,la Marina del Prat Vermell,45-49,3,3,0
2015,3,Sants-Montjuïc,13,la Marina de Port,45-49,73,64,9
2015,3,Sants-Montjuïc,14,la Font de la Guatlla,45-49,27,24,3
2015,3,Sants-Montjuïc,15,Hostafrancs,45-49,62,48,14
2015,3,Sants-Montjuïc,16,la Bordeta,45-49,46,38,8
2015,3,Sants-Montjuïc,17,Sants - Badal,45-49,80,80,0
2015,3,Sants-Montjuïc,18,Sants,45-49,156,110,46
2015,4,Les Corts,19,les Corts,45-49,114,80,34
2015,4,Les Corts,20,la Maternitat i Sant Ramon,45-49,55,44,11
2015,4,Les Corts,21,Pedralbes,45-49,52,28,24
2015,5,Sarrià-Sant Gervasi,22,"Vallvidrera, el Tibidabo i les Planes",45-49,28,16,12
2015,5,Sarrià-Sant Gervasi,23,Sarrià,45-49,95,42,53
2015,5,Sarrià-Sant Gervasi,24,les Tres Torres,45-49,65,32,33
2015,5,Sarrià-Sant Gervasi,25,Sant Gervasi - la Bonanova,45-49,74,54,20
2015,5,Sarrià-Sant Gervasi,26,Sant Gervasi - Galvany,45-49,164,73,91
2015,5,Sarrià-Sant Gervasi,27,el Putxet i el Farró,45-49,72,44,28
2015,6,Gràcia,28,Vallcarca i els Penitents,45-49,31,22,9
2015,6,Gràcia,29,el Coll,45-49,17,12,5
2015,6,Gràcia,30,la Salut,45-49,32,10,22
2015,6,Gràcia,31,la Vila de Gràcia,45-49,141,114,27
2015,6,Gràcia,32,el Camp d'en Grassot i Gràcia Nova,45-49,55,43,12
2015,7,Horta-Guinardó,33,el Baix Guinardó,45-49,62,45,17
2015,7,Horta-Guinardó,34,Can Baró,45-49,22,23,-1
2015,7,Horta-Guinardó,35,el Guinardó,45-49,92,76,16
2015,7,Horta-Guinardó,36,la Font d'en Fargues,45-49,13,11,2
2015,7,Horta-Guinardó,37,el Carmel,45-49,63,60,3
2015,7,Horta-Guinardó,38,la Teixonera,45-49,22,16,6
2015,7,Horta-Guinardó,39,Sant Genís dels Agudells,45-49,19,17,2
2015,7,Horta-Guinardó,40,Montbau,45-49,17,13,4
2015,7,Horta-Guinardó,41,la Vall d'Hebron,45-49,13,9,4
2015,7,Horta-Guinardó,42,la Clota,45-49,2,1,1
2015,7,Horta-Guinardó,43,Horta,45-49,69,50,19
2015,8,Nou Barris,44,Vilapicina i la Torre Llobeta,45-49,66,42,24
2015,8,Nou Barris,45,Porta,45-49,70,40,30
2015,8,Nou Barris,46,el Turó de la Peira,45-49,53,20,33
2015,8,Nou Barris,47,Can Peguera,45-49,5,4,1
2015,8,Nou Barris,48,la Guineueta,45-49,24,20,4
2015,8,Nou Barris,49,Canyelles,45-49,11,8,3
2015,8,Nou Barris,50,les Roquetes,45-49,45,43,2
2015,8,Nou Barris,51,Verdun,45-49,27,18,9
2015,8,Nou Barris,52,la Prosperitat,45-49,75,42,33
2015,8,Nou Barris,53,la Trinitat Nova,45-49,19,13,6
2015,8,Nou Barris,54,Torre Baró,45-49,6,7,-1
2015,8,Nou Barris,55,Ciutat Meridiana,45-49,41,31,10
2015,8,Nou Barris,56,Vallbona,45-49,4,1,3
2015,9,Sant Andreu,57,la Trinitat Vella,45-49,35,26,9
2015,9,Sant Andreu,58,Baró de Viver,45-49,3,6,-3
2015,9,Sant Andreu,59,el Bon Pastor,45-49,37,36,1
2015,9,Sant Andreu,60,Sant Andreu,45-49,117,86,31
2015,9,Sant Andreu,61,la Sagrera,45-49,71,52,19
2015,9,Sant Andreu,62,el Congrés i els Indians,45-49,42,33,9
2015,9,Sant Andreu,63,Navas,45-49,60,40,20
2015,10,Sant Martí,64,el Camp de l'Arpa del Clot,45-49,98,87,11
2015,10,Sant Martí,65,el Clot,45-49,81,64,17
2015,10,Sant Martí,66,el Parc i la Llacuna del Poblenou,45-49,38,30,8
2015,10,Sant Martí,67,la Vila Olímpica del Poblenou,45-49,37,18,19
2015,10,Sant Martí,68,el Poblenou,45-49,89,61,28
2015,10,Sant Martí,69,Diagonal Mar i el Front Marítim del Poblenou,45-49,36,38,-2
2015,10,Sant Martí,70,el Besòs i el Maresme,45-49,103,85,18
2015,10,Sant Martí,71,Provençals del Poblenou,45-49,52,36,16
2015,10,Sant Martí,72,Sant Martí de Provençals,45-49,53,32,21
2015,10,Sant Martí,73,la Verneda i la Pau,45-49,63,67,-4
2015,1,Ciutat Vella,1,el Raval,50-54,162,119,43
2015,1,Ciutat Vella,2,el Barri Gòtic,50-54,60,35,25
2015,1,Ciutat Vella,3,la Barceloneta,50-54,38,25,13
2015,1,Ciutat Vella,4,"Sant Pere, Santa Caterina i la Ribera",50-54,71,51,20
2015,2,Eixample,5,el Fort Pienc,50-54,71,55,16
2015,2,Eixample,6,la Sagrada Família,50-54,118,74,44
2015,2,Eixample,7,la Dreta de l'Eixample,50-54,114,68,46
2015,2,Eixample,8,l'Antiga Esquerra de l'Eixample,50-54,116,67,49
2015,2,Eixample,9,la Nova Esquerra de l'Eixample,50-54,128,90,38
2015,2,Eixample,10,Sant Antoni,50-54,76,64,12
2015,3,Sants-Montjuïc,11,el Poble Sec,50-54,91,88,3
2015,3,Sants-Montjuïc,12,la Marina del Prat Vermell,50-54,4,0,4
2015,3,Sants-Montjuïc,13,la Marina de Port,50-54,60,64,-4
2015,3,Sants-Montjuïc,14,la Font de la Guatlla,50-54,31,16,15
2015,3,Sants-Montjuïc,15,Hostafrancs,50-54,35,32,3
2015,3,Sants-Montjuïc,16,la Bordeta,50-54,38,22,16
2015,3,Sants-Montjuïc,17,Sants - Badal,50-54,70,51,19
2015,3,Sants-Montjuïc,18,Sants,50-54,87,96,-9
2015,4,Les Corts,19,les Corts,50-54,89,60,29
2015,4,Les Corts,20,la Maternitat i Sant Ramon,50-54,52,42,10
2015,4,Les Corts,21,Pedralbes,50-54,53,23,30
2015,5,Sarrià-Sant Gervasi,22,"Vallvidrera, el Tibidabo i les Planes",50-54,10,2,8
2015,5,Sarrià-Sant Gervasi,23,Sarrià,50-54,57,25,32
2015,5,Sarrià-Sant Gervasi,24,les Tres Torres,50-54,37,21,16
2015,5,Sarrià-Sant Gervasi,25,Sant Gervasi - la Bonanova,50-54,64,56,8
2015,5,Sarrià-Sant Gervasi,26,Sant Gervasi - Galvany,50-54,111,65,46
2015,5,Sarrià-Sant Gervasi,27,el Putxet i el Farró,50-54,71,52,19
2015,6,Gràcia,28,Vallcarca i els Penitents,50-54,24,21,3
2015,6,Gràcia,29,el Coll,50-54,12,6,6
2015,6,Gràcia,30,la Salut,50-54,15,17,-2
2015,6,Gràcia,31,la Vila de Gràcia,50-54,104,78,26
2015,6,Gràcia,32,el Camp d'en Grassot i Gràcia Nova,50-54,59,28,31
2015,7,Horta-Guinardó,33,el Baix Guinardó,50-54,53,29,24
2015,7,Horta-Guinardó,34,Can Baró,50-54,19,13,6
2015,7,Horta-Guinardó,35,el Guinardó,50-54,63,63,0
2015,7,Horta-Guinardó,36,la Font d'en Fargues,50-54,7,10,-3
2015,7,Horta-Guinardó,37,el Carmel,50-54,64,37,27
2015,7,Horta-Guinardó,38,la Teixonera,50-54,21,13,8
2015,7,Horta-Guinardó,39,Sant Genís dels Agudells,50-54,12,11,1
2015,7,Horta-Guinardó,40,Montbau,50-54,11,9,2
2015,7,Horta-Guinardó,41,la Vall d'Hebron,50-54,12,4,8
2015,7,Horta-Guinardó,42,la Clota,50-54,2,2,0
2015,7,Horta-Guinardó,43,Horta,50-54,42,33,9
2015,8,Nou Barris,44,Vilapicina i la Torre Llobeta,50-54,51,28,23
2015,8,Nou Barris,45,Porta,50-54,51,36,15
2015,8,Nou Barris,46,el Turó de la Peira,50-54,36,28,8
2015,8,Nou Barris,47,Can Peguera,50-54,1,3,-2
2015,8,Nou Barris,48,la Guineueta,50-54,18,15,3
2015,8,Nou Barris,49,Canyelles,50-54,6,4,2
2015,8,Nou Barris,50,les Roquetes,50-54,34,29,5
2015,8,Nou Barris,51,Verdun,50-54,30,21,9
2015,8,Nou Barris,52,la Prosperitat,50-54,55,31,24
2015,8,Nou Barris,53,la Trinitat Nova,50-54,13,15,-2
2015,8,Nou Barris,54,Torre Baró,50-54,6,3,3
2015,8,Nou Barris,55,Ciutat Meridiana,50-54,27,25,2
2015,8,Nou Barris,56,Vallbona,50-54,2,0,2
2015,9,Sant Andreu,57,la Trinitat Vella,50-54,28,24,4
2015,9,Sant Andreu,58,Baró de Viver,50-54,5,3,2
2015,9,Sant Andreu,59,el Bon Pastor,50-54,35,15,20
2015,9,Sant Andreu,60,Sant Andreu,50-54,76,56,20
2015,9,Sant Andreu,61,la Sagrera,50-54,52,36,16
2015,9,Sant Andreu,62,el Congrés i els Indians,50-54,22,33,-11
2015,9,Sant Andreu,63,Navas,50-54,45,37,8
2015,10,Sant Martí,64,el Camp de l'Arpa del Clot,50-54,76,64,12
2015,10,Sant Martí,65,el Clot,50-54,51,41,10
2015,10,Sant Martí,66,el Parc i la Llacuna del Poblenou,50-54,30,20,10
2015,10,Sant Martí,67,la Vila Olímpica del Poblenou,50-54,24,16,8
2015,10,Sant Martí,68,el Poblenou,50-54,51,35,16
2015,10,Sant Martí,69,Diagonal Mar i el Front Marítim del Poblenou,50-54,23,19,4
2015,10,Sant Martí,70,el Besòs i el Maresme,50-54,55,54,1
2015,10,Sant Martí,71,Provençals del Poblenou,50-54,31,34,-3
2015,10,Sant Martí,72,Sant Martí de Provençals,50-54,58,47,11
2015,10,Sant Martí,73,la Verneda i la Pau,50-54,55,46,9
2015,1,Ciutat Vella,1,el Raval,55-59,114,79,35
2015,1,Ciutat Vella,2,el Barri Gòtic,55-59,50,27,23
2015,1,Ciutat Vella,3,la Barceloneta,55-59,23,10,13
2015,1,Ciutat Vella,4,"Sant Pere, Santa Caterina i la Ribera",55-59,50,38,12
2015,2,Eixample,5,el Fort Pienc,55-59,53,40,13
2015,2,Eixample,6,la Sagrada Família,55-59,81,63,18
2015,2,Eixample,7,la Dreta de l'Eixample,55-59,71,53,18
2015,2,Eixample,8,l'Antiga Esquerra de l'Eixample,55-59,71,65,6
2015,2,Eixample,9,la Nova Esquerra de l'Eixample,55-59,105,63,42
2015,2,Eixample,10,Sant Antoni,55-59,70,44,26
2015,3,Sants-Montjuïc,11,el Poble Sec,55-59,70,60,10
2015,3,Sants-Montjuïc,12,la Marina del Prat Vermell,55-59,2,2,0
2015,3,Sants-Montjuïc,13,la Marina de Port,55-59,35,28,7
2015,3,Sants-Montjuïc,14,la Font de la Guatlla,55-59,17,14,3
2015,3,Sants-Montjuïc,15,Hostafrancs,55-59,25,16,9
2015,3,Sants-Montjuïc,16,la Bordeta,55-59,26,16,10
2015,3,Sants-Montjuïc,17,Sants - Badal,55-59,41,37,4
2015,3,Sants-Montjuïc,18,Sants,55-59,61,64,-3
2015,4,Les Corts,19,les Corts,55-59,60,49,11
2015,4,Les Corts,20,la Maternitat i Sant Ramon,55-59,36,31,5
2015,4,Les Corts,21,Pedralbes,55-59,21,12,9
2015,5,Sarrià-Sant Gervasi,22,"Vallvidrera, el Tibidabo i les Planes",55-59,7,8,-1
2015,5,Sarrià-Sant Gervasi,23,Sarrià,55-59,38,31,7
2015,5,Sarrià-Sant Gervasi,24,les Tres Torres,55-59,17,22,-5
2015,5,Sarrià-Sant Gervasi,25,Sant Gervasi - la Bonanova,55-59,42,37,5
2015,5,Sarrià-Sant Gervasi,26,Sant Gervasi - Galvany,55-59,81,45,36
2015,5,Sarrià-Sant Gervasi,27,el Putxet i el Farró,55-59,43,26,17
2015,6,Gràcia,28,Vallcarca i els Penitents,55-59,22,20,2
2015,6,Gràcia,29,el Coll,55-59,11,5,6
2015,6,Gràcia,30,la Salut,55-59,19,16,3
2015,6,Gràcia,31,la Vila de Gràcia,55-59,73,52,21
2015,6,Gràcia,32,el Camp d'en Grassot i Gràcia Nova,55-59,46,31,15
2015,7,Horta-Guinardó,33,el Baix Guinardó,55-59,40,17,23
2015,7,Horta-Guinardó,34,Can Baró,55-59,22,6,16
2015,7,Horta-Guinardó,35,el Guinardó,55-59,61,46,15
2015,7,Horta-Guinardó,36,la Font d'en Fargues,55-59,4,9,-5
2015,7,Horta-Guinardó,37,el Carmel,55-59,37,23,14
2015,7,Horta-Guinardó,38,la Teixonera,55-59,10,8,2
2015,7,Horta-Guinardó,39,Sant Genís dels Agudells,55-59,8,8,0
2015,7,Horta-Guinardó,40,Montbau,55-59,12,7,5
2015,7,Horta-Guinardó,41,la Vall d'Hebron,55-59,4,5,-1
2015,7,Horta-Guinardó,42,la Clota,55-59,1,0,1
2015,7,Horta-Guinardó,43,Horta,55-59,44,16,28
2015,8,Nou Barris,44,Vilapicina i la Torre Llobeta,55-59,49,21,28
2015,8,Nou Barris,45,Porta,55-59,34,20,14
2015,8,Nou Barris,46,el Turó de la Peira,55-59,22,18,4
2015,8,Nou Barris,47,Can Peguera,55-59,4,0,4
2015,8,Nou Barris,48,la Guineueta,55-59,19,13,6
2015,8,Nou Barris,49,Canyelles,55-59,5,4,1
2015,8,Nou Barris,50,les Roquetes,55-59,21,18,3
2015,8,Nou Barris,51,Verdun,55-59,19,17,2
2015,8,Nou Barris,52,la Prosperitat,55-59,37,25,12
2015,8,Nou Barris,53,la Trinitat Nova,55-59,16,13,3
2015,8,Nou Barris,54,Torre Baró,55-59,6,2,4
2015,8,Nou Barris,55,Ciutat Meridiana,55-59,16,9,7
2015,8,Nou Barris,56,Vallbona,55-59,1,1,0
2015,9,Sant Andreu,57,la Trinitat Vella,55-59,19,15,4
2015,9,Sant Andreu,58,Baró de Viver,55-59,7,2,5
2015,9,Sant Andreu,59,el Bon Pastor,55-59,17,10,7
2015,9,Sant Andreu,60,Sant Andreu,55-59,64,46,18
2015,9,Sant Andreu,61,la Sagrera,55-59,34,16,18
2015,9,Sant Andreu,62,el Congrés i els Indians,55-59,14,21,-7
2015,9,Sant Andreu,63,Navas,55-59,25,33,-8
2015,10,Sant Martí,64,el Camp de l'Arpa del Clot,55-59,51,46,5
2015,10,Sant Martí,65,el Clot,55-59,36,26,10
2015,10,Sant Martí,66,el Parc i la Llacuna del Poblenou,55-59,22,17,5
2015,10,Sant Martí,67,la Vila Olímpica del Poblenou,55-59,16,12,4
2015,10,Sant Martí,68,el Poblenou,55-59,48,34,14
2015,10,Sant Martí,69,Diagonal Mar i el Front Marítim del Poblenou,55-59,15,9,6
2015,10,Sant Martí,70,el Besòs i el Maresme,55-59,52,43,9
2015,10,Sant Martí,71,Provençals del Poblenou,55-59,29,23,6
2015,10,Sant Martí,72,Sant Martí de Provençals,55-59,36,22,14
2015,10,Sant Martí,73,la Verneda i la Pau,55-59,41,30,11
2015,1,Ciutat Vella,1,el Raval,60-64,81,48,33
2015,1,Ciutat Vella,2,el Barri Gòtic,60-64,33,23,10
2015,1,Ciutat Vella,3,la Barceloneta,60-64,12,23,-11
2015,1,Ciutat Vella,4,"Sant Pere, Santa Caterina i la Ribera",60-64,30,22,8
2015,2,Eixample,5,el Fort Pienc,60-64,23,33,-10
2015,2,Eixample,6,la Sagrada Família,60-64,49,54,-5
2015,2,Eixample,7,la Dreta de l'Eixample,60-64,79,57,22
2015,2,Eixample,8,l'Antiga Esquerra de l'Eixample,60-64,54,45,9
2015,2,Eixample,9,la Nova Esquerra de l'Eixample,60-64,75,64,11
2015,2,Eixample,10,Sant Antoni,60-64,39,39,0
2015,3,Sants-Montjuïc,11,el Poble Sec,60-64,56,35,21
2015,3,Sants-Montjuïc,12,la Marina del Prat Vermell,60-64,2,1,1
2015,3,Sants-Montjuïc,13,la Marina de Port,60-64,32,22,10
2015,3,Sants-Montjuïc,14,la Font de la Guatlla,60-64,19,7,12
2015,3,Sants-Montjuïc,15,Hostafrancs,60-64,17,20,-3
2015,3,Sants-Montjuïc,16,la Bordeta,60-64,25,14,11
2015,3,Sants-Montjuïc,17,Sants - Badal,60-64,35,39,-4
2015,3,Sants-Montjuïc,18,Sants,60-64,46,44,2
2015,4,Les Corts,19,les Corts,60-64,40,53,-13
2015,4,Les Corts,20,la Maternitat i Sant Ramon,60-64,32,36,-4
2015,4,Les Corts,21,Pedralbes,60-64,13,14,-1
2015,5,Sarrià-Sant Gervasi,22,"Vallvidrera, el Tibidabo i les Planes",60-64,4,6,-2
2015,5,Sarrià-Sant Gervasi,23,Sarrià,60-64,26,26,0
2015,5,Sarrià-Sant Gervasi,24,les Tres Torres,60-64,15,21,-6
2015,5,Sarrià-Sant Gervasi,25,Sant Gervasi - la Bonanova,60-64,27,27,0
2015,5,Sarrià-Sant Gervasi,26,Sant Gervasi - Galvany,60-64,63,60,3
2015,5,Sarrià-Sant Gervasi,27,el Putxet i el Farró,60-64,36,38,-2
2015,6,Gràcia,28,Vallcarca i els Penitents,60-64,14,10,4
2015,6,Gràcia,29,el Coll,60-64,7,8,-1
2015,6,Gràcia,30,la Salut,60-64,11,13,-2
2015,6,Gràcia,31,la Vila de Gràcia,60-64,63,50,13
2015,6,Gràcia,32,el Camp d'en Grassot i Gràcia Nova,60-64,40,27,13
2015,7,Horta-Guinardó,33,el Baix Guinardó,60-64,32,31,1
2015,7,Horta-Guinardó,34,Can Baró,60-64,11,7,4
2015,7,Horta-Guinardó,35,el Guinardó,60-64,32,20,12
2015,7,Horta-Guinardó,36,la Font d'en Fargues,60-64,5,13,-8
2015,7,Horta-Guinardó,37,el Carmel,60-64,35,26,9
2015,7,Horta-Guinardó,38,la Teixonera,60-64,6,9,-3
2015,7,Horta-Guinardó,39,Sant Genís dels Agudells,60-64,7,7,0
2015,7,Horta-Guinardó,40,Montbau,60-64,5,3,2
2015,7,Horta-Guinardó,41,la Vall d'Hebron,60-64,7,4,3
2015,7,Horta-Guinardó,42,la Clota,60-64,0,0,0
2015,7,Horta-Guinardó,43,Horta,60-64,26,16,10
2015,8,Nou Barris,44,Vilapicina i la Torre Llobeta,60-64,21,23,-2
2015,8,Nou Barris,45,Porta,60-64,24,16,8
2015,8,Nou Barris,46,el Turó de la Peira,60-64,19,10,9
2015,8,Nou Barris,47,Can Peguera,60-64,0,1,-1
2015,8,Nou Barris,48,la Guineueta,60-64,14,7,7
2015,8,Nou Barris,49,Canyelles,60-64,6,8,-2
2015,8,Nou Barris,50,les Roquetes,60-64,19,14,5
2015,8,Nou Barris,51,Verdun,60-64,15,7,8
2015,8,Nou Barris,52,la Prosperitat,60-64,17,20,-3
2015,8,Nou Barris,53,la Trinitat Nova,60-64,6,5,1
2015,8,Nou Barris,54,Torre Baró,60-64,4,1,3
2015,8,Nou Barris,55,Ciutat Meridiana,60-64,17,12,5
2015,8,Nou Barris,56,Vallbona,60-64,1,0,1
2015,9,Sant Andreu,57,la Trinitat Vella,60-64,8,6,2
2015,9,Sant Andreu,58,Baró de Viver,60-64,6,5,1
2015,9,Sant Andreu,59,el Bon Pastor,60-64,12,15,-3
2015,9,Sant Andreu,60,Sant Andreu,60-64,50,48,2
2015,9,Sant Andreu,61,la Sagrera,60-64,35,22,13
2015,9,Sant Andreu,62,el Congrés i els Indians,60-64,11,15,-4
2015,9,Sant Andreu,63,Navas,60-64,25,18,7
2015,10,Sant Martí,64,el Camp de l'Arpa del Clot,60-64,49,34,15
2015,10,Sant Martí,65,el Clot,60-64,32,33,-1
2015,10,Sant Martí,66,el Parc i la Llacuna del Poblenou,60-64,15,14,1
2015,10,Sant Martí,67,la Vila Olímpica del Poblenou,60-64,10,6,4
2015,10,Sant Martí,68,el Poblenou,60-64,34,27,7
2015,10,Sant Martí,69,Diagonal Mar i el Front Marítim del Poblenou,60-64,19,12,7
2015,10,Sant Martí,70,el Besòs i el Maresme,60-64,18,23,-5
2015,10,Sant Martí,71,Provençals del Poblenou,60-64,22,18,4
2015,10,Sant Martí,72,Sant Martí de Provençals,60-64,29,16,13
2015,10,Sant Martí,73,la Verneda i la Pau,60-64,31,29,2
2015,1,Ciutat Vella,1,el Raval,65-69,51,46,5
2015,1,Ciutat Vella,2,el Barri Gòtic,65-69,16,14,2
2015,1,Ciutat Vella,3,la Barceloneta,65-69,19,16,3
2015,1,Ciutat Vella,4,"Sant Pere, Santa Caterina i la Ribera",65-69,20,28,-8
2015,2,Eixample,5,el Fort Pienc,65-69,30,20,10
2015,2,Eixample,6,la Sagrada Família,65-69,57,31,26
2015,2,Eixample,7,la Dreta de l'Eixample,65-69,60,59,1
2015,2,Eixample,8,l'Antiga Esquerra de l'Eixample,65-69,42,28,14
2015,2,Eixample,9,la Nova Esquerra de l'Eixample,65-69,71,53,18
2015,2,Eixample,10,Sant Antoni,65-69,28,34,-6
2015,3,Sants-Montjuïc,11,el Poble Sec,65-69,20,45,-25
2015,3,Sants-Montjuïc,12,la Marina del Prat Vermell,65-69,0,1,-1
2015,3,Sants-Montjuïc,13,la Marina de Port,65-69,26,18,8
2015,3,Sants-Montjuïc,14,la Font de la Guatlla,65-69,7,7,0
2015,3,Sants-Montjuïc,15,Hostafrancs,65-69,22,15,7
2015,3,Sants-Montjuïc,16,la Bordeta,65-69,17,24,-7
2015,3,Sants-Montjuïc,17,Sants - Badal,65-69,24,29,-5
2015,3,Sants-Montjuïc,18,Sants,65-69,35,59,-24
2015,4,Les Corts,19,les Corts,65-69,55,36,19
2015,4,Les Corts,20,la Maternitat i Sant Ramon,65-69,23,23,0
2015,4,Les Corts,21,Pedralbes,65-69,15,17,-2
2015,5,Sarrià-Sant Gervasi,22,"Vallvidrera, el Tibidabo i les Planes",65-69,0,8,-8
2015,5,Sarrià-Sant Gervasi,23,Sarrià,65-69,22,26,-4
2015,5,Sarrià-Sant Gervasi,24,les Tres Torres,65-69,15,19,-4
2015,5,Sarrià-Sant Gervasi,25,Sant Gervasi - la Bonanova,65-69,18,31,-13
2015,5,Sarrià-Sant Gervasi,26,Sant Gervasi - Galvany,65-69,47,53,-6
2015,5,Sarrià-Sant Gervasi,27,el Putxet i el Farró,65-69,21,37,-16
2015,6,Gràcia,28,Vallcarca i els Penitents,65-69,17,12,5
2015,6,Gràcia,29,el Coll,65-69,5,9,-4
2015,6,Gràcia,30,la Salut,65-69,19,9,10
2015,6,Gràcia,31,la Vila de Gràcia,65-69,51,50,1
2015,6,Gràcia,32,el Camp d'en Grassot i Gràcia Nova,65-69,21,37,-16
2015,7,Horta-Guinardó,33,el Baix Guinardó,65-69,23,30,-7
2015,7,Horta-Guinardó,34,Can Baró,65-69,9,12,-3
2015,7,Horta-Guinardó,35,el Guinardó,65-69,30,23,7
2015,7,Horta-Guinardó,36,la Font d'en Fargues,65-69,8,7,1
2015,7,Horta-Guinardó,37,el Carmel,65-69,16,28,-12
2015,7,Horta-Guinardó,38,la Teixonera,65-69,9,6,3
2015,7,Horta-Guinardó,39,Sant Genís dels Agudells,65-69,4,7,-3
2015,7,Horta-Guinardó,40,Montbau,65-69,2,1,1
2015,7,Horta-Guinardó,41,la Vall d'Hebron,65-69,3,4,-1
2015,7,Horta-Guinardó,42,la Clota,65-69,0,1,-1
2015,7,Horta-Guinardó,43,Horta,65-69,8,20,-12
2015,8,Nou Barris,44,Vilapicina i la Torre Llobeta,65-69,11,19,-8
2015,8,Nou Barris,45,Porta,65-69,12,16,-4
2015,8,Nou Barris,46,el Turó de la Peira,65-69,11,11,0
2015,8,Nou Barris,47,Can Peguera,65-69,1,0,1
2015,8,Nou Barris,48,la Guineueta,65-69,11,21,-10
2015,8,Nou Barris,49,Canyelles,65-69,7,4,3
2015,8,Nou Barris,50,les Roquetes,65-69,12,16,-4
2015,8,Nou Barris,51,Verdun,65-69,5,5,0
2015,8,Nou Barris,52,la Prosperitat,65-69,15,17,-2
2015,8,Nou Barris,53,la Trinitat Nova,65-69,4,2,2
2015,8,Nou Barris,54,Torre Baró,65-69,0,1,-1
2015,8,Nou Barris,55,Ciutat Meridiana,65-69,6,15,-9
2015,8,Nou Barris,56,Vallbona,65-69,1,0,1
2015,9,Sant Andreu,57,la Trinitat Vella,65-69,6,4,2
2015,9,Sant Andreu,58,Baró de Viver,65-69,1,0,1
2015,9,Sant Andreu,59,el Bon Pastor,65-69,8,16,-8
2015,9,Sant Andreu,60,Sant Andreu,65-69,30,43,-13
2015,9,Sant Andreu,61,la Sagrera,65-69,26,25,1
2015,9,Sant Andreu,62,el Congrés i els Indians,65-69,10,5,5
2015,9,Sant Andreu,63,Navas,65-69,13,18,-5
2015,10,Sant Martí,64,el Camp de l'Arpa del Clot,65-69,40,33,7
2015,10,Sant Martí,65,el Clot,65-69,26,21,5
2015,10,Sant Martí,66,el Parc i la Llacuna del Poblenou,65-69,12,16,-4
2015,10,Sant Martí,67,la Vila Olímpica del Poblenou,65-69,10,5,5
2015,10,Sant Martí,68,el Poblenou,65-69,25,30,-5
2015,10,Sant Martí,69,Diagonal Mar i el Front Marítim del Poblenou,65-69,14,13,1
2015,10,Sant Martí,70,el Besòs i el Maresme,65-69,11,15,-4
2015,10,Sant Martí,71,Provençals del Poblenou,65-69,20,13,7
2015,10,Sant Martí,72,Sant Martí de Provençals,65-69,26,14,12
2015,10,Sant Martí,73,la Verneda i la Pau,65-69,25,22,3
2015,1,Ciutat Vella,1,el Raval,70-74,32,28,4
2015,1,Ciutat Vella,2,el Barri Gòtic,70-74,13,12,1
2015,1,Ciutat Vella,3,la Barceloneta,70-74,8,7,1
2015,1,Ciutat Vella,4,"Sant Pere, Santa Caterina i la Ribera",70-74,17,15,2
2015,2,Eixample,5,el Fort Pienc,70-74,17,16,1
2015,2,Eixample,6,la Sagrada Família,70-74,33,23,10
2015,2,Eixample,7,la Dreta de l'Eixample,70-74,39,37,2
2015,2,Eixample,8,l'Antiga Esquerra de l'Eixample,70-74,24,23,1
2015,2,Eixample,9,la Nova Esquerra de l'Eixample,70-74,39,27,12
2015,2,Eixample,10,Sant Antoni,70-74,12,21,-9
2015,3,Sants-Montjuïc,11,el Poble Sec,70-74,20,23,-3
2015,3,Sants-Montjuïc,12,la Marina del Prat Vermell,70-74,0,0,0
2015,3,Sants-Montjuïc,13,la Marina de Port,70-74,13,17,-4
2015,3,Sants-Montjuïc,14,la Font de la Guatlla,70-74,11,5,6
2015,3,Sants-Montjuïc,15,Hostafrancs,70-74,14,11,3
2015,3,Sants-Montjuïc,16,la Bordeta,70-74,11,10,1
2015,3,Sants-Montjuïc,17,Sants - Badal,70-74,15,25,-10
2015,3,Sants-Montjuïc,18,Sants,70-74,13,35,-22
2015,4,Les Corts,19,les Corts,70-74,33,24,9
2015,4,Les Corts,20,la Maternitat i Sant Ramon,70-74,24,13,11
2015,4,Les Corts,21,Pedralbes,70-74,11,10,1
2015,5,Sarrià-Sant Gervasi,22,"Vallvidrera, el Tibidabo i les Planes",70-74,0,4,-4
2015,5,Sarrià-Sant Gervasi,23,Sarrià,70-74,10,16,-6
2015,5,Sarrià-Sant Gervasi,24,les Tres Torres,70-74,9,17,-8
2015,5,Sarrià-Sant Gervasi,25,Sant Gervasi - la Bonanova,70-74,21,26,-5
2015,5,Sarrià-Sant Gervasi,26,Sant Gervasi - Galvany,70-74,38,34,4
2015,5,Sarrià-Sant Gervasi,27,el Putxet i el Farró,70-74,21,14,7
2015,6,Gràcia,28,Vallcarca i els Penitents,70-74,10,11,-1
2015,6,Gràcia,29,el Coll,70-74,5,4,1
2015,6,Gràcia,30,la Salut,70-74,5,7,-2
2015,6,Gràcia,31,la Vila de Gràcia,70-74,25,23,2
2015,6,Gràcia,32,el Camp d'en Grassot i Gràcia Nova,70-74,25,19,6
2015,7,Horta-Guinardó,33,el Baix Guinardó,70-74,17,26,-9
2015,7,Horta-Guinardó,34,Can Baró,70-74,5,7,-2
2015,7,Horta-Guinardó,35,el Guinardó,70-74,20,16,4
2015,7,Horta-Guinardó,36,la Font d'en Fargues,70-74,3,8,-5
2015,7,Horta-Guinardó,37,el Carmel,70-74,13,27,-14
2015,7,Horta-Guinardó,38,la Teixonera,70-74,6,4,2
2015,7,Horta-Guinardó,39,Sant Genís dels Agudells,70-74,1,10,-9
2015,7,Horta-Guinardó,40,Montbau,70-74,4,2,2
2015,7,Horta-Guinardó,41,la Vall d'Hebron,70-74,2,6,-4
2015,7,Horta-Guinardó,42,la Clota,70-74,0,0,0
2015,7,Horta-Guinardó,43,Horta,70-74,12,6,6
2015,8,Nou Barris,44,Vilapicina i la Torre Llobeta,70-74,7,13,-6
2015,8,Nou Barris,45,Porta,70-74,11,13,-2
2015,8,Nou Barris,46,el Turó de la Peira,70-74,5,3,2
2015,8,Nou Barris,47,Can Peguera,70-74,0,0,0
2015,8,Nou Barris,48,la Guineueta,70-74,14,11,3
2015,8,Nou Barris,49,Canyelles,70-74,3,2,1
2015,8,Nou Barris,50,les Roquetes,70-74,10,6,4
2015,8,Nou Barris,51,Verdun,70-74,8,4,4
2015,8,Nou Barris,52,la Prosperitat,70-74,7,21,-14
2015,8,Nou Barris,53,la Trinitat Nova,70-74,1,0,1
2015,8,Nou Barris,54,Torre Baró,70-74,2,0,2
2015,8,Nou Barris,55,Ciutat Meridiana,70-74,4,4,0
2015,8,Nou Barris,56,Vallbona,70-74,0,2,-2
2015,9,Sant Andreu,57,la Trinitat Vella,70-74,2,4,-2
2015,9,Sant Andreu,58,Baró de Viver,70-74,2,1,1
2015,9,Sant Andreu,59,el Bon Pastor,70-74,4,7,-3
2015,9,Sant Andreu,60,Sant Andreu,70-74,31,24,7
2015,9,Sant Andreu,61,la Sagrera,70-74,15,10,5
2015,9,Sant Andreu,62,el Congrés i els Indians,70-74,6,3,3
2015,9,Sant Andreu,63,Navas,70-74,14,13,1
2015,10,Sant Martí,64,el Camp de l'Arpa del Clot,70-74,31,22,9
2015,10,Sant Martí,65,el Clot,70-74,13,15,-2
2015,10,Sant Martí,66,el Parc i la Llacuna del Poblenou,70-74,4,13,-9
2015,10,Sant Martí,67,la Vila Olímpica del Poblenou,70-74,5,4,1
2015,10,Sant Martí,68,el Poblenou,70-74,14,9,5
2015,10,Sant Martí,69,Diagonal Mar i el Front Marítim del Poblenou,70-74,9,5,4
2015,10,Sant Martí,70,el Besòs i el Maresme,70-74,11,6,5
2015,10,Sant Martí,71,Provençals del Poblenou,70-74,15,7,8
2015,10,Sant Martí,72,Sant Martí de Provençals,70-74,11,12,-1
2015,10,Sant Martí,73,la Verneda i la Pau,70-74,15,18,-3
2015,1,Ciutat Vella,1,el Raval,75-79,14,21,-7
2015,1,Ciutat Vella,2,el Barri Gòtic,75-79,10,11,-1
2015,1,Ciutat Vella,3,la Barceloneta,75-79,7,9,-2
2015,1,Ciutat Vella,4,"Sant Pere, Santa Caterina i la Ribera",75-79,7,18,-11
2015,2,Eixample,5,el Fort Pienc,75-79,9,11,-2
2015,2,Eixample,6,la Sagrada Família,75-79,20,15,5
2015,2,Eixample,7,la Dreta de l'Eixample,75-79,23,23,0
2015,2,Eixample,8,l'Antiga Esquerra de l'Eixample,75-79,23,25,-2
2015,2,Eixample,9,la Nova Esquerra de l'Eixample,75-79,23,29,-6
2015,2,Eixample,10,Sant Antoni,75-79,12,14,-2
2015,3,Sants-Montjuïc,11,el Poble Sec,75-79,20,29,-9
2015,3,Sants-Montjuïc,12,la Marina del Prat Vermell,75-79,0,0,0
2015,3,Sants-Montjuïc,13,la Marina de Port,75-79,8,16,-8
2015,3,Sants-Montjuïc,14,la Font de la Guatlla,75-79,7,4,3
2015,3,Sants-Montjuïc,15,Hostafrancs,75-79,6,8,-2
2015,3,Sants-Montjuïc,16,la Bordeta,75-79,6,11,-5
2015,3,Sants-Montjuïc,17,Sants - Badal,75-79,14,10,4
2015,3,Sants-Montjuïc,18,Sants,75-79,14,16,-2
2015,4,Les Corts,19,les Corts,75-79,21,20,1
2015,4,Les Corts,20,la Maternitat i Sant Ramon,75-79,10,11,-1
2015,4,Les Corts,21,Pedralbes,75-79,7,5,2
2015,5,Sarrià-Sant Gervasi,22,"Vallvidrera, el Tibidabo i les Planes",75-79,3,4,-1
2015,5,Sarrià-Sant Gervasi,23,Sarrià,75-79,10,11,-1
2015,5,Sarrià-Sant Gervasi,24,les Tres Torres,75-79,8,9,-1
2015,5,Sarrià-Sant Gervasi,25,Sant Gervasi - la Bonanova,75-79,14,22,-8
2015,5,Sarrià-Sant Gervasi,26,Sant Gervasi - Galvany,75-79,31,22,9
2015,5,Sarrià-Sant Gervasi,27,el Putxet i el Farró,75-79,7,14,-7
2015,6,Gràcia,28,Vallcarca i els Penitents,75-79,5,6,-1
2015,6,Gràcia,29,el Coll,75-79,3,0,3
2015,6,Gràcia,30,la Salut,75-79,4,7,-3
2015,6,Gràcia,31,la Vila de Gràcia,75-79,9,17,-8
2015,6,Gràcia,32,el Camp d'en Grassot i Gràcia Nova,75-79,15,9,6
2015,7,Horta-Guinardó,33,el Baix Guinardó,75-79,10,15,-5
2015,7,Horta-Guinardó,34,Can Baró,75-79,5,3,2
2015,7,Horta-Guinardó,35,el Guinardó,75-79,10,14,-4
2015,7,Horta-Guinardó,36,la Font d'en Fargues,75-79,3,2,1
2015,7,Horta-Guinardó,37,el Carmel,75-79,10,25,-15
2015,7,Horta-Guinardó,38,la Teixonera,75-79,9,7,2
2015,7,Horta-Guinardó,39,Sant Genís dels Agudells,75-79,4,7,-3
2015,7,Horta-Guinardó,40,Montbau,75-79,4,3,1
2015,7,Horta-Guinardó,41,la Vall d'Hebron,75-79,5,4,1
2015,7,Horta-Guinardó,42,la Clota,75-79,0,3,-3
2015,7,Horta-Guinardó,43,Horta,75-79,7,6,1
2015,8,Nou Barris,44,Vilapicina i la Torre Llobeta,75-79,9,11,-2
2015,8,Nou Barris,45,Porta,75-79,7,14,-7
2015,8,Nou Barris,46,el Turó de la Peira,75-79,3,6,-3
2015,8,Nou Barris,47,Can Peguera,75-79,0,3,-3
2015,8,Nou Barris,48,la Guineueta,75-79,5,9,-4
2015,8,Nou Barris,49,Canyelles,75-79,1,3,-2
2015,8,Nou Barris,50,les Roquetes,75-79,10,5,5
2015,8,Nou Barris,51,Verdun,75-79,4,5,-1
2015,8,Nou Barris,52,la Prosperitat,75-79,11,12,-1
2015,8,Nou Barris,53,la Trinitat Nova,75-79,2,2,0
2015,8,Nou Barris,54,Torre Baró,75-79,1,0,1
2015,8,Nou Barris,55,Ciutat Meridiana,75-79,1,7,-6
2015,8,Nou Barris,56,Vallbona,75-79,4,0,4
2015,9,Sant Andreu,57,la Trinitat Vella,75-79,4,4,0
2015,9,Sant Andreu,58,Baró de Viver,75-79,1,3,-2
2015,9,Sant Andreu,59,el Bon Pastor,75-79,3,8,-5
2015,9,Sant Andreu,60,Sant Andreu,75-79,18,22,-4
2015,9,Sant Andreu,61,la Sagrera,75-79,10,13,-3
2015,9,Sant Andreu,62,el Congrés i els Indians,75-79,6,2,4
2015,9,Sant Andreu,63,Navas,75-79,10,7,3
2015,10,Sant Martí,64,el Camp de l'Arpa del Clot,75-79,16,14,2
2015,10,Sant Martí,65,el Clot,75-79,7,12,-5
2015,10,Sant Martí,66,el Parc i la Llacuna del Poblenou,75-79,2,7,-5
2015,10,Sant Martí,67,la Vila Olímpica del Poblenou,75-79,2,4,-2
2015,10,Sant Martí,68,el Poblenou,75-79,10,16,-6
2015,10,Sant Martí,69,Diagonal Mar i el Front Marítim del Poblenou,75-79,5,3,2
2015,10,Sant Martí,70,el Besòs i el Maresme,75-79,3,13,-10
2015,10,Sant Martí,71,Provençals del Poblenou,75-79,7,6,1
2015,10,Sant Martí,72,Sant Martí de Provençals,75-79,6,14,-8
2015,10,Sant Martí,73,la Verneda i la Pau,75-79,4,14,-10
2015,1,Ciutat Vella,1,el Raval,80-84,13,27,-14
2015,1,Ciutat Vella,2,el Barri Gòtic,80-84,7,9,-2
2015,1,Ciutat Vella,3,la Barceloneta,80-84,1,10,-9
2015,1,Ciutat Vella,4,"Sant Pere, Santa Caterina i la Ribera",80-84,9,13,-4
2015,2,Eixample,5,el Fort Pienc,80-84,5,8,-3
2015,2,Eixample,6,la Sagrada Família,80-84,21,25,-4
2015,2,Eixample,7,la Dreta de l'Eixample,80-84,19,27,-8
2015,2,Eixample,8,l'Antiga Esquerra de l'Eixample,80-84,20,29,-9
2015,2,Eixample,9,la Nova Esquerra de l'Eixample,80-84,31,34,-3
2015,2,Eixample,10,Sant Antoni,80-84,15,26,-11
2015,3,Sants-Montjuïc,11,el Poble Sec,80-84,14,20,-6
2015,3,Sants-Montjuïc,12,la Marina del Prat Vermell,80-84,0,0,0
2015,3,Sants-Montjuïc,13,la Marina de Port,80-84,6,17,-11
2015,3,Sants-Montjuïc,14,la Font de la Guatlla,80-84,4,2,2
2015,3,Sants-Montjuïc,15,Hostafrancs,80-84,6,6,0
2015,3,Sants-Montjuïc,16,la Bordeta,80-84,6,14,-8
2015,3,Sants-Montjuïc,17,Sants - Badal,80-84,5,15,-10
2015,3,Sants-Montjuïc,18,Sants,80-84,16,22,-6
2015,4,Les Corts,19,les Corts,80-84,19,22,-3
2015,4,Les Corts,20,la Maternitat i Sant Ramon,80-84,16,11,5
2015,4,Les Corts,21,Pedralbes,80-84,3,6,-3
2015,5,Sarrià-Sant Gervasi,22,"Vallvidrera, el Tibidabo i les Planes",80-84,1,2,-1
2015,5,Sarrià-Sant Gervasi,23,Sarrià,80-84,10,6,4
2015,5,Sarrià-Sant Gervasi,24,les Tres Torres,80-84,5,8,-3
2015,5,Sarrià-Sant Gervasi,25,Sant Gervasi - la Bonanova,80-84,18,23,-5
2015,5,Sarrià-Sant Gervasi,26,Sant Gervasi - Galvany,80-84,15,19,-4
2015,5,Sarrià-Sant Gervasi,27,el Putxet i el Farró,80-84,9,10,-1
2015,6,Gràcia,28,Vallcarca i els Penitents,80-84,2,6,-4
2015,6,Gràcia,29,el Coll,80-84,2,1,1
2015,6,Gràcia,30,la Salut,80-84,3,3,0
2015,6,Gràcia,31,la Vila de Gràcia,80-84,15,26,-11
2015,6,Gràcia,32,el Camp d'en Grassot i Gràcia Nova,80-84,14,18,-4
2015,7,Horta-Guinardó,33,el Baix Guinardó,80-84,5,16,-11
2015,7,Horta-Guinardó,34,Can Baró,80-84,4,6,-2
2015,7,Horta-Guinardó,35,el Guinardó,80-84,12,17,-5
2015,7,Horta-Guinardó,36,la Font d'en Fargues,80-84,2,3,-1
2015,7,Horta-Guinardó,37,el Carmel,80-84,8,25,-17
2015,7,Horta-Guinardó,38,la Teixonera,80-84,3,7,-4
2015,7,Horta-Guinardó,39,Sant Genís dels Agudells,80-84,5,8,-3
2015,7,Horta-Guinardó,40,Montbau,80-84,2,2,0
2015,7,Horta-Guinardó,41,la Vall d'Hebron,80-84,1,3,-2
2015,7,Horta-Guinardó,42,la Clota,80-84,0,1,-1
2015,7,Horta-Guinardó,43,Horta,80-84,14,15,-1
2015,8,Nou Barris,44,Vilapicina i la Torre Llobeta,80-84,15,15,0
2015,8,Nou Barris,45,Porta,80-84,7,17,-10
2015,8,Nou Barris,46,el Turó de la Peira,80-84,5,14,-9
2015,8,Nou Barris,47,Can Peguera,80-84,0,1,-1
2015,8,Nou Barris,48,la Guineueta,80-84,3,8,-5
2015,8,Nou Barris,49,Canyelles,80-84,3,6,-3
2015,8,Nou Barris,50,les Roquetes,80-84,4,7,-3
2015,8,Nou Barris,51,Verdun,80-84,1,10,-9
2015,8,Nou Barris,52,la Prosperitat,80-84,9,16,-7
2015,8,Nou Barris,53,la Trinitat Nova,80-84,0,7,-7
2015,8,Nou Barris,54,Torre Baró,80-84,0,0,0
2015,8,Nou Barris,55,Ciutat Meridiana,80-84,4,4,0
2015,8,Nou Barris,56,Vallbona,80-84,3,2,1
2015,9,Sant Andreu,57,la Trinitat Vella,80-84,1,8,-7
2015,9,Sant Andreu,58,Baró de Viver,80-84,0,5,-5
2015,9,Sant Andreu,59,el Bon Pastor,80-84,8,10,-2
2015,9,Sant Andreu,60,Sant Andreu,80-84,26,30,-4
2015,9,Sant Andreu,61,la Sagrera,80-84,11,19,-8
2015,9,Sant Andreu,62,el Congrés i els Indians,80-84,4,8,-4
2015,9,Sant Andreu,63,Navas,80-84,7,11,-4
2015,10,Sant Martí,64,el Camp de l'Arpa del Clot,80-84,13,15,-2
2015,10,Sant Martí,65,el Clot,80-84,2,14,-12
2015,10,Sant Martí,66,el Parc i la Llacuna del Poblenou,80-84,6,7,-1
2015,10,Sant Martí,67,la Vila Olímpica del Poblenou,80-84,3,3,0
2015,10,Sant Martí,68,el Poblenou,80-84,9,13,-4
2015,10,Sant Martí,69,Diagonal Mar i el Front Marítim del Poblenou,80-84,5,4,1
2015,10,Sant Martí,70,el Besòs i el Maresme,80-84,15,15,0
2015,10,Sant Martí,71,Provençals del Poblenou,80-84,9,12,-3
2015,10,Sant Martí,72,Sant Martí de Provençals,80-84,11,31,-20
2015,10,Sant Martí,73,la Verneda i la Pau,80-84,11,19,-8
2015,1,Ciutat Vella,1,el Raval,85-89,7,17,-10
2015,1,Ciutat Vella,2,el Barri Gòtic,85-89,2,10,-8
2015,1,Ciutat Vella,3,la Barceloneta,85-89,2,13,-11
2015,1,Ciutat Vella,4,"Sant Pere, Santa Caterina i la Ribera",85-89,5,18,-13
2015,2,Eixample,5,el Fort Pienc,85-89,14,13,1
2015,2,Eixample,6,la Sagrada Família,85-89,15,20,-5
2015,2,Eixample,7,la Dreta de l'Eixample,85-89,14,21,-7
2015,2,Eixample,8,l'Antiga Esquerra de l'Eixample,85-89,14,22,-8
2015,2,Eixample,9,la Nova Esquerra de l'Eixample,85-89,15,25,-10
2015,2,Eixample,10,Sant Antoni,85-89,7,22,-15
2015,3,Sants-Montjuïc,11,el Poble Sec,85-89,10,41,-31
2015,3,Sants-Montjuïc,12,la Marina del Prat Vermell,85-89,1,0,1
2015,3,Sants-Montjuïc,13,la Marina de Port,85-89,9,15,-6
2015,3,Sants-Montjuïc,14,la Font de la Guatlla,85-89,9,4,5
2015,3,Sants-Montjuïc,15,Hostafrancs,85-89,6,6,0
2015,3,Sants-Montjuïc,16,la Bordeta,85-89,5,10,-5
2015,3,Sants-Montjuïc,17,Sants - Badal,85-89,4,16,-12
2015,3,Sants-Montjuïc,18,Sants,85-89,17,21,-4
2015,4,Les Corts,19,les Corts,85-89,19,32,-13
2015,4,Les Corts,20,la Maternitat i Sant Ramon,85-89,9,16,-7
2015,4,Les Corts,21,Pedralbes,85-89,2,4,-2
2015,5,Sarrià-Sant Gervasi,22,"Vallvidrera, el Tibidabo i les Planes",85-89,3,4,-1
2015,5,Sarrià-Sant Gervasi,23,Sarrià,85-89,14,13,1
2015,5,Sarrià-Sant Gervasi,24,les Tres Torres,85-89,12,4,8
2015,5,Sarrià-Sant Gervasi,25,Sant Gervasi - la Bonanova,85-89,10,12,-2
2015,5,Sarrià-Sant Gervasi,26,Sant Gervasi - Galvany,85-89,9,27,-18
2015,5,Sarrià-Sant Gervasi,27,el Putxet i el Farró,85-89,2,6,-4
2015,6,Gràcia,28,Vallcarca i els Penitents,85-89,2,8,-6
2015,6,Gràcia,29,el Coll,85-89,5,2,3
2015,6,Gràcia,30,la Salut,85-89,6,6,0
2015,6,Gràcia,31,la Vila de Gràcia,85-89,18,24,-6
2015,6,Gràcia,32,el Camp d'en Grassot i Gràcia Nova,85-89,13,16,-3
2015,7,Horta-Guinardó,33,el Baix Guinardó,85-89,7,16,-9
2015,7,Horta-Guinardó,34,Can Baró,85-89,3,5,-2
2015,7,Horta-Guinardó,35,el Guinardó,85-89,12,23,-11
2015,7,Horta-Guinardó,36,la Font d'en Fargues,85-89,1,3,-2
2015,7,Horta-Guinardó,37,el Carmel,85-89,11,15,-4
2015,7,Horta-Guinardó,38,la Teixonera,85-89,3,4,-1
2015,7,Horta-Guinardó,39,Sant Genís dels Agudells,85-89,5,7,-2
2015,7,Horta-Guinardó,40,Montbau,85-89,5,3,2
2015,7,Horta-Guinardó,41,la Vall d'Hebron,85-89,0,1,-1
2015,7,Horta-Guinardó,42,la Clota,85-89,0,0,0
2015,7,Horta-Guinardó,43,Horta,85-89,15,17,-2
2015,8,Nou Barris,44,Vilapicina i la Torre Llobeta,85-89,11,13,-2
2015,8,Nou Barris,45,Porta,85-89,5,15,-10
2015,8,Nou Barris,46,el Turó de la Peira,85-89,5,13,-8
2015,8,Nou Barris,47,Can Peguera,85-89,0,1,-1
2015,8,Nou Barris,48,la Guineueta,85-89,6,8,-2
2015,8,Nou Barris,49,Canyelles,85-89,1,5,-4
2015,8,Nou Barris,50,les Roquetes,85-89,3,2,1
2015,8,Nou Barris,51,Verdun,85-89,3,5,-2
2015,8,Nou Barris,52,la Prosperitat,85-89,11,18,-7
2015,8,Nou Barris,53,la Trinitat Nova,85-89,1,12,-11
2015,8,Nou Barris,54,Torre Baró,85-89,1,1,0
2015,8,Nou Barris,55,Ciutat Meridiana,85-89,1,3,-2
2015,8,Nou Barris,56,Vallbona,85-89,3,0,3
2015,9,Sant Andreu,57,la Trinitat Vella,85-89,1,5,-4
2015,9,Sant Andreu,58,Baró de Viver,85-89,0,1,-1
2015,9,Sant Andreu,59,el Bon Pastor,85-89,2,8,-6
2015,9,Sant Andreu,60,Sant Andreu,85-89,20,17,3
2015,9,Sant Andreu,61,la Sagrera,85-89,10,16,-6
2015,9,Sant Andreu,62,el Congrés i els Indians,85-89,4,11,-7
2015,9,Sant Andreu,63,Navas,85-89,3,14,-11
2015,10,Sant Martí,64,el Camp de l'Arpa del Clot,85-89,12,15,-3
2015,10,Sant Martí,65,el Clot,85-89,4,12,-8
2015,10,Sant Martí,66,el Parc i la Llacuna del Poblenou,85-89,5,5,0
2015,10,Sant Martí,67,la Vila Olímpica del Poblenou,85-89,2,3,-1
2015,10,Sant Martí,68,el Poblenou,85-89,5,18,-13
2015,10,Sant Martí,69,Diagonal Mar i el Front Marítim del Poblenou,85-89,7,10,-3
2015,10,Sant Martí,70,el Besòs i el Maresme,85-89,4,21,-17
2015,10,Sant Martí,71,Provençals del Poblenou,85-89,2,7,-5
2015,10,Sant Martí,72,Sant Martí de Provençals,85-89,8,22,-14
2015,10,Sant Martí,73,la Verneda i la Pau,85-89,7,21,-14
2015,1,Ciutat Vella,1,el Raval,90-94,1,13,-12
2015,1,Ciutat Vella,2,el Barri Gòtic,90-94,1,1,0
2015,1,Ciutat Vella,3,la Barceloneta,90-94,2,4,-2
2015,1,Ciutat Vella,4,"Sant Pere, Santa Caterina i la Ribera",90-94,0,8,-8
2015,2,Eixample,5,el Fort Pienc,90-94,3,9,-6
2015,2,Eixample,6,la Sagrada Família,90-94,3,22,-19
2015,2,Eixample,7,la Dreta de l'Eixample,90-94,14,16,-2
2015,2,Eixample,8,l'Antiga Esquerra de l'Eixample,90-94,7,16,-9
2015,2,Eixample,9,la Nova Esquerra de l'Eixample,90-94,9,17,-8
2015,2,Eixample,10,Sant Antoni,90-94,4,9,-5
2015,3,Sants-Montjuïc,11,el Poble Sec,90-94,4,19,-15
2015,3,Sants-Montjuïc,12,la Marina del Prat Vermell,90-94,0,0,0
2015,3,Sants-Montjuïc,13,la Marina de Port,90-94,2,12,-10
2015,3,Sants-Montjuïc,14,la Font de la Guatlla,90-94,3,5,-2
2015,3,Sants-Montjuïc,15,Hostafrancs,90-94,5,4,1
2015,3,Sants-Montjuïc,16,la Bordeta,90-94,9,7,2
2015,3,Sants-Montjuïc,17,Sants - Badal,90-94,7,10,-3
2015,3,Sants-Montjuïc,18,Sants,90-94,8,16,-8
2015,4,Les Corts,19,les Corts,90-94,5,13,-8
2015,4,Les Corts,20,la Maternitat i Sant Ramon,90-94,6,8,-2
2015,4,Les Corts,21,Pedralbes,90-94,0,2,-2
2015,5,Sarrià-Sant Gervasi,22,"Vallvidrera, el Tibidabo i les Planes",90-94,0,3,-3
2015,5,Sarrià-Sant Gervasi,23,Sarrià,90-94,6,7,-1
2015,5,Sarrià-Sant Gervasi,24,les Tres Torres,90-94,6,6,0
2015,5,Sarrià-Sant Gervasi,25,Sant Gervasi - la Bonanova,90-94,2,4,-2
2015,5,Sarrià-Sant Gervasi,26,Sant Gervasi - Galvany,90-94,8,8,0
2015,5,Sarrià-Sant Gervasi,27,el Putxet i el Farró,90-94,4,9,-5
2015,6,Gràcia,28,Vallcarca i els Penitents,90-94,2,4,-2
2015,6,Gràcia,29,el Coll,90-94,1,0,1
2015,6,Gràcia,30,la Salut,90-94,5,7,-2
2015,6,Gràcia,31,la Vila de Gràcia,90-94,8,10,-2
2015,6,Gràcia,32,el Camp d'en Grassot i Gràcia Nova,90-94,2,11,-9
2015,7,Horta-Guinardó,33,el Baix Guinardó,90-94,7,8,-1
2015,7,Horta-Guinardó,34,Can Baró,90-94,3,2,1
2015,7,Horta-Guinardó,35,el Guinardó,90-94,6,16,-10
2015,7,Horta-Guinardó,36,la Font d'en Fargues,90-94,2,1,1
2015,7,Horta-Guinardó,37,el Carmel,90-94,3,7,-4
2015,7,Horta-Guinardó,38,la Teixonera,90-94,0,2,-2
2015,7,Horta-Guinardó,39,Sant Genís dels Agudells,90-94,2,2,0
2015,7,Horta-Guinardó,40,Montbau,90-94,0,3,-3
2015,7,Horta-Guinardó,41,la Vall d'Hebron,90-94,0,2,-2
2015,7,Horta-Guinardó,42,la Clota,90-94,0,1,-1
2015,7,Horta-Guinardó,43,Horta,90-94,8,8,0
2015,8,Nou Barris,44,Vilapicina i la Torre Llobeta,90-94,5,8,-3
2015,8,Nou Barris,45,Porta,90-94,5,9,-4
2015,8,Nou Barris,46,el Turó de la Peira,90-94,2,11,-9
2015,8,Nou Barris,47,Can Peguera,90-94,0,1,-1
2015,8,Nou Barris,48,la Guineueta,90-94,3,5,-2
2015,8,Nou Barris,49,Canyelles,90-94,1,2,-1
2015,8,Nou Barris,50,les Roquetes,90-94,2,2,0
2015,8,Nou Barris,51,Verdun,90-94,1,4,-3
2015,8,Nou Barris,52,la Prosperitat,90-94,3,9,-6
2015,8,Nou Barris,53,la Trinitat Nova,90-94,1,2,-1
2015,8,Nou Barris,54,Torre Baró,90-94,0,0,0
2015,8,Nou Barris,55,Ciutat Meridiana,90-94,0,5,-5
2015,8,Nou Barris,56,Vallbona,90-94,1,0,1
2015,9,Sant Andreu,57,la Trinitat Vella,90-94,2,3,-1
2015,9,Sant Andreu,58,Baró de Viver,90-94,0,2,-2
2015,9,Sant Andreu,59,el Bon Pastor,90-94,3,4,-1
2015,9,Sant Andreu,60,Sant Andreu,90-94,6,18,-12
2015,9,Sant Andreu,61,la Sagrera,90-94,1,7,-6
2015,9,Sant Andreu,62,el Congrés i els Indians,90-94,1,7,-6
2015,9,Sant Andreu,63,Navas,90-94,1,7,-6
2015,10,Sant Martí,64,el Camp de l'Arpa del Clot,90-94,1,11,-10
2015,10,Sant Martí,65,el Clot,90-94,1,8,-7
2015,10,Sant Martí,66,el Parc i la Llacuna del Poblenou,90-94,5,9,-4
2015,10,Sant Martí,67,la Vila Olímpica del Poblenou,90-94,0,0,0
2015,10,Sant Martí,68,el Poblenou,90-94,3,7,-4
2015,10,Sant Martí,69,Diagonal Mar i el Front Marítim del Poblenou,90-94,1,3,-2
2015,10,Sant Martí,70,el Besòs i el Maresme,90-94,2,15,-13
2015,10,Sant Martí,71,Provençals del Poblenou,90-94,2,6,-4
2015,10,Sant Martí,72,Sant Martí de Provençals,90-94,2,13,-11
2015,10,Sant Martí,73,la Verneda i la Pau,90-94,5,9,-4
2015,1,Ciutat Vella,1,el Raval,95-99,0,4,-4
2015,1,Ciutat Vella,2,el Barri Gòtic,95-99,1,1,0
2015,1,Ciutat Vella,3,la Barceloneta,95-99,0,0,0
2015,1,Ciutat Vella,4,"Sant Pere, Santa Caterina i la Ribera",95-99,0,2,-2
2015,2,Eixample,5,el Fort Pienc,95-99,0,6,-6
2015,2,Eixample,6,la Sagrada Família,95-99,4,1,3
2015,2,Eixample,7,la Dreta de l'Eixample,95-99,2,5,-3
2015,2,Eixample,8,l'Antiga Esquerra de l'Eixample,95-99,2,5,-3
2015,2,Eixample,9,la Nova Esquerra de l'Eixample,95-99,0,10,-10
2015,2,Eixample,10,Sant Antoni,95-99,3,4,-1
2015,3,Sants-Montjuïc,11,el Poble Sec,95-99,0,3,-3
2015,3,Sants-Montjuïc,12,la Marina del Prat Vermell,95-99,0,0,0
2015,3,Sants-Montjuïc,13,la Marina de Port,95-99,1,1,0
2015,3,Sants-Montjuïc,14,la Font de la Guatlla,95-99,0,1,-1
2015,3,Sants-Montjuïc,15,Hostafrancs,95-99,1,0,1
2015,3,Sants-Montjuïc,16,la Bordeta,95-99,1,1,0
2015,3,Sants-Montjuïc,17,Sants - Badal,95-99,2,3,-1
2015,3,Sants-Montjuïc,18,Sants,95-99,1,5,-4
2015,4,Les Corts,19,les Corts,95-99,2,2,0
2015,4,Les Corts,20,la Maternitat i Sant Ramon,95-99,2,4,-2
2015,4,Les Corts,21,Pedralbes,95-99,0,1,-1
2015,5,Sarrià-Sant Gervasi,22,"Vallvidrera, el Tibidabo i les Planes",95-99,0,0,0
2015,5,Sarrià-Sant Gervasi,23,Sarrià,95-99,1,2,-1
2015,5,Sarrià-Sant Gervasi,24,les Tres Torres,95-99,1,1,0
2015,5,Sarrià-Sant Gervasi,25,Sant Gervasi - la Bonanova,95-99,1,0,1
2015,5,Sarrià-Sant Gervasi,26,Sant Gervasi - Galvany,95-99,4,2,2
2015,5,Sarrià-Sant Gervasi,27,el Putxet i el Farró,95-99,1,1,0
2015,6,Gràcia,28,Vallcarca i els Penitents,95-99,0,0,0
2015,6,Gràcia,29,el Coll,95-99,1,0,1
2015,6,Gràcia,30,la Salut,95-99,1,0,1
2015,6,Gràcia,31,la Vila de Gràcia,95-99,3,2,1
2015,6,Gràcia,32,el Camp d'en Grassot i Gràcia Nova,95-99,2,9,-7
2015,7,Horta-Guinardó,33,el Baix Guinardó,95-99,4,1,3
2015,7,Horta-Guinardó,34,Can Baró,95-99,0,0,0
2015,7,Horta-Guinardó,35,el Guinardó,95-99,0,4,-4
2015,7,Horta-Guinardó,36,la Font d'en Fargues,95-99,1,1,0
2015,7,Horta-Guinardó,37,el Carmel,95-99,0,0,0
2015,7,Horta-Guinardó,38,la Teixonera,95-99,0,0,0
2015,7,Horta-Guinardó,39,Sant Genís dels Agudells,95-99,0,0,0
2015,7,Horta-Guinardó,40,Montbau,95-99,0,1,-1
2015,7,Horta-Guinardó,41,la Vall d'Hebron,95-99,0,1,-1
2015,7,Horta-Guinardó,42,la Clota,95-99,0,0,0
2015,7,Horta-Guinardó,43,Horta,95-99,1,1,0
2015,8,Nou Barris,44,Vilapicina i la Torre Llobeta,95-99,0,0,0
2015,8,Nou Barris,45,Porta,95-99,2,5,-3
2015,8,Nou Barris,46,el Turó de la Peira,95-99,0,3,-3
2015,8,Nou Barris,47,Can Peguera,95-99,0,0,0
2015,8,Nou Barris,48,la Guineueta,95-99,0,1,-1
2015,8,Nou Barris,49,Canyelles,95-99,0,0,0
2015,8,Nou Barris,50,les Roquetes,95-99,1,3,-2
2015,8,Nou Barris,51,Verdun,95-99,0,1,-1
2015,8,Nou Barris,52,la Prosperitat,95-99,0,2,-2
2015,8,Nou Barris,53,la Trinitat Nova,95-99,0,0,0
2015,8,Nou Barris,54,Torre Baró,95-99,0,0,0
2015,8,Nou Barris,55,Ciutat Meridiana,95-99,0,0,0
2015,8,Nou Barris,56,Vallbona,95-99,0,0,0
2015,9,Sant Andreu,57,la Trinitat Vella,95-99,0,0,0
2015,9,Sant Andreu,58,Baró de Viver,95-99,0,0,0
2015,9,Sant Andreu,59,el Bon Pastor,95-99,0,0,0
2015,9,Sant Andreu,60,Sant Andreu,95-99,0,6,-6
2015,9,Sant Andreu,61,la Sagrera,95-99,2,1,1
2015,9,Sant Andreu,62,el Congrés i els Indians,95-99,1,5,-4
2015,9,Sant Andreu,63,Navas,95-99,1,2,-1
2015,10,Sant Martí,64,el Camp de l'Arpa del Clot,95-99,1,2,-1
2015,10,Sant Martí,65,el Clot,95-99,1,1,0
2015,10,Sant Martí,66,el Parc i la Llacuna del Poblenou,95-99,0,4,-4
2015,10,Sant Martí,67,la Vila Olímpica del Poblenou,95-99,0,0,0
2015,10,Sant Martí,68,el Poblenou,95-99,0,0,0
2015,10,Sant Martí,69,Diagonal Mar i el Front Marítim del Poblenou,95-99,0,1,-1
2015,10,Sant Martí,70,el Besòs i el Maresme,95-99,1,0,1
2015,10,Sant Martí,71,Provençals del Poblenou,95-99,0,0,0
2015,10,Sant Martí,72,Sant Martí de Provençals,95-99,1,2,-1
2015,10,Sant Martí,73,la Verneda i la Pau,95-99,1,2,-1
2015,1,Ciutat Vella,1,el Raval,>=100,1,1,0
2015,1,Ciutat Vella,2,el Barri Gòtic,>=100,0,0,0
2015,1,Ciutat Vella,3,la Barceloneta,>=100,0,0,0
2015,1,Ciutat Vella,4,"Sant Pere, Santa Caterina i la Ribera",>=100,0,0,0
2015,2,Eixample,5,el Fort Pienc,>=100,0,2,-2
2015,2,Eixample,6,la Sagrada Família,>=100,1,1,0
2015,2,Eixample,7,la Dreta de l'Eixample,>=100,0,1,-1
2015,2,Eixample,8,l'Antiga Esquerra de l'Eixample,>=100,0,1,-1
2015,2,Eixample,9,la Nova Esquerra de l'Eixample,>=100,0,0,0
2015,2,Eixample,10,Sant Antoni,>=100,0,0,0
2015,3,Sants-Montjuïc,11,el Poble Sec,>=100,0,0,0
2015,3,Sants-Montjuïc,12,la Marina del Prat Vermell,>=100,0,0,0
2015,3,Sants-Montjuïc,13,la Marina de Port,>=100,0,0,0
2015,3,Sants-Montjuïc,14,la Font de la Guatlla,>=100,1,0,1
2015,3,Sants-Montjuïc,15,Hostafrancs,>=100,0,0,0
2015,3,Sants-Montjuïc,16,la Bordeta,>=100,0,0,0
2015,3,Sants-Montjuïc,17,Sants - Badal,>=100,2,0,2
2015,3,Sants-Montjuïc,18,Sants,>=100,1,0,1
2015,4,Les Corts,19,les Corts,>=100,0,0,0
2015,4,Les Corts,20,la Maternitat i Sant Ramon,>=100,1,1,0
2015,4,Les Corts,21,Pedralbes,>=100,0,0,0
2015,5,Sarrià-Sant Gervasi,22,"Vallvidrera, el Tibidabo i les Planes",>=100,0,0,0
2015,5,Sarrià-Sant Gervasi,23,Sarrià,>=100,0,0,0
2015,5,Sarrià-Sant Gervasi,24,les Tres Torres,>=100,0,0,0
2015,5,Sarrià-Sant Gervasi,25,Sant Gervasi - la Bonanova,>=100,0,0,0
2015,5,Sarrià-Sant Gervasi,26,Sant Gervasi - Galvany,>=100,0,1,-1
2015,5,Sarrià-Sant Gervasi,27,el Putxet i el Farró,>=100,0,0,0
2015,6,Gràcia,28,Vallcarca i els Penitents,>=100,0,0,0
2015,6,Gràcia,29,el Coll,>=100,0,0,0
2015,6,Gràcia,30,la Salut,>=100,1,0,1
2015,6,Gràcia,31,la Vila de Gràcia,>=100,1,1,0
2015,6,Gràcia,32,el Camp d'en Grassot i Gràcia Nova,>=100,0,0,0
2015,7,Horta-Guinardó,33,el Baix Guinardó,>=100,0,0,0
2015,7,Horta-Guinardó,34,Can Baró,>=100,0,0,0
2015,7,Horta-Guinardó,35,el Guinardó,>=100,0,1,-1
2015,7,Horta-Guinardó,36,la Font d'en Fargues,>=100,0,0,0
2015,7,Horta-Guinardó,37,el Carmel,>=100,0,0,0
2015,7,Horta-Guinardó,38,la Teixonera,>=100,0,0,0
2015,7,Horta-Guinardó,39,Sant Genís dels Agudells,>=100,0,1,-1
2015,7,Horta-Guinardó,40,Montbau,>=100,0,0,0
2015,7,Horta-Guinardó,41,la Vall d'Hebron,>=100,0,0,0
2015,7,Horta-Guinardó,42,la Clota,>=100,0,0,0
2015,7,Horta-Guinardó,43,Horta,>=100,0,0,0
2015,8,Nou Barris,44,Vilapicina i la Torre Llobeta,>=100,0,0,0
2015,8,Nou Barris,45,Porta,>=100,0,0,0
2015,8,Nou Barris,46,el Turó de la Peira,>=100,0,0,0
2015,8,Nou Barris,47,Can Peguera,>=100,0,0,0
2015,8,Nou Barris,48,la Guineueta,>=100,0,0,0
2015,8,Nou Barris,49,Canyelles,>=100,0,0,0
2015,8,Nou Barris,50,les Roquetes,>=100,0,0,0
2015,8,Nou Barris,51,Verdun,>=100,0,0,0
2015,8,Nou Barris,52,la Prosperitat,>=100,0,1,-1
2015,8,Nou Barris,53,la Trinitat Nova,>=100,0,0,0
2015,8,Nou Barris,54,Torre Baró,>=100,0,0,0
2015,8,Nou Barris,55,Ciutat Meridiana,>=100,0,0,0
2015,8,Nou Barris,56,Vallbona,>=100,0,0,0
2015,9,Sant Andreu,57,la Trinitat Vella,>=100,0,0,0
2015,9,Sant Andreu,58,Baró de Viver,>=100,0,0,0
2015,9,Sant Andreu,59,el Bon Pastor,>=100,0,0,0
2015,9,Sant Andreu,60,Sant Andreu,>=100,0,0,0
2015,9,Sant Andreu,61,la Sagrera,>=100,0,1,-1
2015,9,Sant Andreu,62,el Congrés i els Indians,>=100,1,1,0
2015,9,Sant Andreu,63,Navas,>=100,0,0,0
2015,10,Sant Martí,64,el Camp de l'Arpa del Clot,>=100,0,1,-1
2015,10,Sant Martí,65,el Clot,>=100,0,0,0
2015,10,Sant Martí,66,el Parc i la Llacuna del Poblenou,>=100,0,1,-1
2015,10,Sant Martí,67,la Vila Olímpica del Poblenou,>=100,0,0,0
2015,10,Sant Martí,68,el Poblenou,>=100,0,0,0
2015,10,Sant Martí,69,Diagonal Mar i el Front Marítim del Poblenou,>=100,0,0,0
2015,10,Sant Martí,70,el Besòs i el Maresme,>=100,0,1,-1
2015,10,Sant Martí,71,Provençals del Poblenou,>=100,0,0,0
2015,10,Sant Martí,72,Sant Martí de Provençals,>=100,0,0,0
2015,10,Sant Martí,73,la Verneda i la Pau,>=100,0,0,0
